abietina|From the Latin ‘abie’ / ‘abies’ meaning ‘silver fir’; and the Latin ‘tina’ / ‘tina’ meaning ‘adjectival suffix implying likeness’.
abrotanifolius|From the Latin ‘abrotani’ / ‘abrotum’ meaning ‘southernwood’; and the Latin ‘folius’ / ‘folium’ meaning ‘leaf’.
abrotanoides|From the Latin ‘abrotan’ / ‘abrotum’ meaning ‘southernwood’; and the Greek ‘oides’ / ‘oides’ meaning ‘in the form of’.
abruptus|From the Latin ‘abruptus’ / ‘abruptus’ meaning ‘sudden’
abyssinica|From the Latin ‘abyssinica’ / ‘abyssinicus’ meaning ‘relating to Abyssinia’
acaulis|From the Latin ‘a’ / ‘a’ meaning ‘without’; and the Latin ‘caulis’ / ‘caulis’ meaning ‘stalk’.
acaulos|From the Latin ‘a’ / ‘a’ meaning ‘without’; and the Greek ‘caulos’ / ‘kaulos’ meaning ‘stalk’.
acerosa|From the Latin ‘acer’ / ‘acer’ meaning ‘maple’; and the Latin ‘osa’ / ‘osus’ meaning ‘adjectival suffix implying likeness’.
acetosella|From the Latin ‘aceto’ / ‘acetum’ meaning ‘vinegar’; and the Latin ‘ella’ / ‘ellus’ meaning ‘diminutizing suffix implying a faint resemblance’.
acinaciformis|From the Greek ‘acinaci’ / ‘akinakos’ meaning ‘scimitar’; and the Latin ‘formis’ / ‘formis’ meaning ‘in the form of’.
acinosa|From the Greek ‘acin’ / ‘akinakos’ meaning ‘scimitar’; and the Latin ‘osa’ / ‘osus’ meaning ‘adjectival suffix implying likeness’.
acipetala|From the Greek ‘acin’ / ‘akinakos’ meaning ‘scimitar’; and the Greek ‘petala’ / ‘petalon’ meaning ‘petal’.
acockii|From the English ‘acockii’ / ‘Acock’ meaning ‘name honours a botanist named Acocks’
acrostichoides|From the Greek ‘acro’ / ‘akros’ meaning ‘summit’; and the stich ‘stichus’ / ‘stichos’ meaning ‘row’.
aculeastrum|From the Latin ‘acule’ / ‘aculeatus’ meaning ‘prickly’; and the Latin ‘astrum’ / ‘aster’ meaning ‘star’.
aculeata|From the Latin ‘aculeata’ / ‘aculeatus’ meaning ‘prickly’
acuminata|From the Latin ‘acuminata’ / ‘acuminatus’ meaning ‘tapering to a point’
acuminatum|From the Latin ‘acuminatum’ / ‘acuminatus’ meaning ‘tapering to a point’
acutiflorum|From the Latin ‘acuti’ / ‘acutus’ meaning ‘sharp’; and the Latin ‘florum’ / ‘flos’ meaning ‘flower’.
acutifolium|From the Latin ‘acuti’ / ‘acutus’ meaning ‘sharp’; and the Latin ‘folium’ / ‘folium’ meaning ‘leaf’.
adiantiformis|From the Greek ‘a’ / ‘a’ meaning ‘not’; and the Greek ‘dianti’ / ‘diantos’ meaning ‘wettable’.
adiantum-nigrum|From the Greek ‘a’ / ‘a’ meaning ‘not’; and the Greek ‘dianti’ / ‘diantos’ meaning ‘wettable’.
adnatus|From the Latin ‘adnatus’ / ‘adnatus’ meaning ‘attached at birth’
adpressa|From the Latin ‘adpressus’ / ‘adpressa’ meaning ‘pressed together’
aduncus|From the Latin ‘aduncus’ / ‘aduncus’ meaning ‘hooked or bent’
aemula|From the Latin ‘aemula’ / ‘aemulus’ meaning ‘similar’
aestivus|From the Latin ‘aestivus’ / ‘aestivus’ meaning ‘relating to the summer’
aethiopica|From the Latin ‘aethiopica’ / ‘aethiopicus’ meaning ‘relating to Ethiopia or Africa in general’
aethiopicum|From the Latin ‘aethiopicum’ / ‘aethiopicus’ meaning ‘relating to Ethiopia or Africa in general’
aethiopicus|From the Latin ‘aethiopicus’ / ‘aethiopicus’ meaning ‘relating to Ethiopia or Africa in general’
affinis|From the Latin ‘affinis’ / ‘affinis’ meaning ‘kinned to’
afra|From the Latin ‘afra’ / ‘africanus’ meaning ‘relating to Africa’
africana|From the Latin ‘africana’ / ‘africanus’ meaning ‘relating to Africa’
africana-caerulea|From the Latin ‘africana’ / ‘africanus’ meaning ‘relating to Africa’; and the Latin ‘caerulea’ / ‘caeruleus’ meaning ‘sky-blue’.
africana-lutea|From the Latin ‘africana’ / ‘africanus’ meaning ‘relating to Africa’; and the Latin ‘lutea’ / ‘luteus’ meaning ‘orange-yellow’.
africanum|From the Latin ‘africanum’ / ‘africanus’ meaning ‘relating to Africa’
africanus|From the Latin ‘africanus’ / ‘africanus’ meaning ‘relating to Africa’
afrum|From the Latin ‘afra’ / ‘africanus’ meaning ‘relating to Africa’
aggregatum|From the Latin ‘aggregatum’ / ‘aggregatus’ meaning ‘aggregated’
alata|From the Latin ‘alata’ / ‘alatus’ meaning ‘winged’
alaternoides|From the Latin ‘alater’ / ‘alatus’ meaning ‘winged’; and the Greek ‘oides’ / ‘oides’ meaning ‘in the form of’.
alatum|From the Latin ‘alatum’ / ‘alatus’ meaning ‘winged’
alatus|From the Latin ‘alatus’ / ‘alatus’ meaning ‘winged’
alba|From the Latin ‘alba’ / ‘albus’ meaning ‘white’
albens|From the Latin ‘albens’ / ‘albens’ meaning ‘turning white’
albicans|From the Latin ‘albicans’ / ‘albicans’ meaning ‘becoming white’
albiflora|From the Latin ‘albi’ / ‘albus’ meaning ‘white’; and the Latin ‘flora’ / ‘flos’ meaning ‘flower’.
albo-aristatus|From the Latin ‘albo’ / ‘albus’ meaning ‘white’; and the Latin ‘aristatus’ / ‘aristatus’ meaning ‘bearded like wheat’.
album|From the Latin ‘album’ / ‘albus’ meaning ‘white’
alchemilloides|From the Latin ‘alchemilla’ / ‘alchemilla’ meaning ‘flower with alchemical associations’; and the Greek ‘oides’ / ‘oides’ meaning ‘in the form of’.
alepecuroides|From the Greek ‘alepecur’ / ‘alopekh’ meaning ‘fox’; and the Greek ‘oides’ / ‘oides’ meaning ‘in the form of’.
aliciae|From the German ‘aliciae’ / ‘Adalheidis’ meaning ‘in honour of  a woman called Alicia’
alliacea|From the Latin ‘alli’ / ‘allium’ meaning ‘garlic’; and the Latin ‘acea’ / ‘aceus’ meaning ‘adjectival suffix implying likeness’.
alnifolia|From the Latin ‘alni’ / ‘alnus’ meaning ‘alder’; and the Latin ‘folia’ / ‘folium’ meaning ‘leaf’.
aloides|From the Greek ‘al’ / ‘aloe’ meaning ‘the plant of that name’; and the Greek ‘oides’ / ‘oides’ meaning ‘in the form of’.
alooides|From the Greek ‘alo’ / ‘aloe’ meaning ‘the plant of that name’; and the Greek ‘oides’ / ‘oides’ meaning ‘in the form of’.
alopecuroides|From the Greek ‘alopecur’ / ‘alopekh’ meaning ‘fox’; and the Greek ‘oides’ / ‘oides’ meaning ‘in the form of’.
alpini|From the Latin ‘alpini’ / ‘alpinus’ meaning ‘alpine’
altheaifolia|From the Greek ‘althaeai’ / ‘althea’ meaning ‘hollyhock’; and the Latin ‘folia’ / ‘folium’ meaning ‘leaf’.
altistylus|From the Latin ‘alti’ / ‘altus’ meaning ‘high’; and the Greek ‘stylus’ / ‘stylos’ meaning ‘column’.
ambigua|From the Latin ‘ambigua’ / ‘ambiguus’ meaning ‘doubtful’
ambiguus|From the Latin ‘ambiguus’ / ‘ambiguus’ meaning ‘doubtful’
amoena|From the Latin ‘amoena’ / ‘amoenus’ meaning ‘pleasant’
amoenus|From the Latin ‘amonus’ / ‘amoenus’ meaning ‘pleasant’
ampla|From the Latin ‘ampla’ / ‘amplus’ meaning ‘large’
amplexicaulis|From the Latin ‘amplexi’ / ‘amplexus’ meaning ‘embracing’; and the Latin ‘caulis’ / ‘caulis’ meaning ‘stalk’.
anceps|From the Latin ‘anceps’ / ‘anceps’ meaning ‘having two heads’
androsacea|From the Greek ‘androsac’ / ‘androsake’ meaning ‘a Greek name for a member of the primrose family’; and the Latin ‘acea’ / ‘aceus’ meaning ‘adjectival suffix implying likeness’.
anemonoides|From the Greek ‘anemon’ / ‘anemone’ meaning ‘a Greek name for a plant that grows in windy locations, whence its derivation from the Greek word for wind, anemos’; and the Greek ‘oides’ / ‘oides’ meaning ‘in the form of’.
anethifolium|From the Greek ‘anethi’ / ‘anethon’ meaning ‘the Greek name for dill’; and the Latin ‘folium’ / ‘folium’ meaning ‘leaf’.
angulata|From the Latin ‘angulata’ / ‘angulatus’ meaning ‘angled’
angusta|From the Latin ‘angusta’ / ‘angustus’ meaning ‘narrow’
angustifolia|From the Latin ‘angusti’ / ‘angustus’ meaning ‘narrow’; and the Latin ‘folia’ / ‘folium’ meaning ‘leaf’.
angustifolius|From the Latin ‘angusti’ / ‘angustus’ meaning ‘narrow’; and the Latin ‘folius’ / ‘folium’ meaning ‘leaf’.
angustus|From the Latin ‘angustus’ / ‘angustus’ meaning ‘narrow’
annectens|From the Latin ‘annectens’ / ‘annectens’ meaning ‘binding’
annua|From the Latin ‘annua’ / ‘annuus’ meaning ‘that which lasts a year’
anomala|From the Latin ‘anomala’ / ‘anomalus’ meaning ‘abnormal’
antarctica|From the Latin ‘anarcticus’ / ‘southern’ meaning ‘’
anthemoides|From the Greek ‘anthe’ / ‘anthos’ meaning ‘flower ’; and the Greek ‘oides’ / ‘oides’ meaning ‘in the form of’.
antholyza|From the Greek ‘antho’ / ‘anthos’ meaning ‘flower’; and the Greek ‘lyza’ / ‘lyssa’ meaning ‘rage’.
antirrhinoides|From the Greek ‘anti’ / ‘ante’ meaning ‘before’; and the Greek ‘rhinos’ / ‘rhin’ meaning ‘nose’.
apetalus|From the Greek ‘a’ / ‘a’ meaning ‘not’; and the Greek ‘petalus’ / ‘petalon’ meaning ‘petal’.
aphylla|From the Greek ‘a’ / ‘a’ meaning ‘not’; and the Greek ‘phylla’ / ‘phyllon’ meaning ‘leaf’.
appendiculata|From the Latin ‘appendic’ / ‘appendix’ meaning ‘attachment’; and the Latin ‘ulata’ / ‘ulatus’ meaning ‘adjectival suffix implying likeness’.
aquatica|From the Latin ‘aquatica’ / ‘aquaticus’ meaning ‘relating to water’
aquilinum|From the Latin ‘aquilinus’ / ‘aquilinum’ meaning ‘eagle-like’
araneosa|From the Latin ‘arenosa’ / ‘arenosus’ meaning ‘sandy’
arborea|From the Latin ‘arborea’ / ‘arboreus’ meaning ‘relating to a tree’
arborescens|From the Latin ‘arborescens’ / ‘arborescens’ meaning ‘becoming tree-like’
arceuthobioides|From the Greek ‘arce’ / ‘arke???’ meaning ‘ward off???’; and the Greek ‘eutho’ / ‘euthos???’ meaning ‘????’.
arenaria|From the Latin ‘arenaria’ / ‘arenarius’ meaning ‘sandy’
arenarium|From the Latin ‘arenarium’ / ‘arenarius’ meaning ‘sandy’
arenarius|From the Latin ‘arenarius’ / ‘arenarius’ meaning ‘sandy’
arenicola|From the Latin ‘areni’ / ‘arena’ meaning ‘sand’; and the Latin ‘cola’ / ‘colare’ meaning ‘inhabit’.
argentea|From the Latin ‘argentea’ / ‘argenteus’ meaning ‘silver ’
argenteum|From the Latin ‘argenteum’ / ‘argenteus’ meaning ‘silver’
argenteus|From the Latin ‘argenteus’ / ‘argenteus’ meaning ‘silver’
argyrella|From the Greek ‘argyr’ / ‘argyros’ meaning ‘silver’; and the Latin ‘ella’ / ‘ellus’ meaning ‘diminutizing suffix implying a faint resemblance’.
argyropa|From the Greek ‘argyr’ / ‘argyros’ meaning ‘silver’; and the Greek ‘opa’ / ‘opsis’ meaning ‘face’.
argyrophylla|From the Greek ‘aryro’ / ‘argyros’ meaning ‘silver’; and the Greek ‘phylla’ / ‘phyllon’ meaning ‘leaf’.
arida|From the Latin ‘arida’ / ‘aridus’ meaning ‘dry’
aristata|From the Latin ‘aristata’ / ‘aristatus’ meaning ‘bearded like wheat’
aristatus|From the Latin ‘aristatus’ / ‘aristatus’ meaning ‘bearded like wheat’
aristidoides|From the Latin ‘aristi’ / ‘arista’ meaning ‘wheat-beard’; and the Greek ‘oides’ / ‘oides’ meaning ‘in  the form of’.
armata|From the Latin ‘armata’ / ‘armatus’ meaning ‘armed’
arniciflorus|From the Latin ‘arnici’ / ‘arnica’ meaning ‘a member of the Asteracids’; and the Latin ‘florus’ / ‘flos’ meaning ‘flower’.
aromatica|From the Latin ‘aromatica’ / ‘aromaticus’ meaning ‘fragrant’
arrhiza|From the Greek ‘a’ / ‘a’ meaning ‘without’; and the Latin ‘rhiza’ / ‘rhiza’ meaning ‘root’.
articularis|From the Latin ‘articularis’ / ‘articularis’ meaning ‘relating to joints’
articulata|From the Latin ‘articulata’ / ‘articulatus’ meaning ‘divided into joints’
arvensis|From the Latin ‘arvensis’ / ‘arvensis’ meaning ‘relating to meadows’
asarina|From the Latin ‘asar’ / ‘asarum’ meaning ‘ginger’; and the Latin ‘ina’ / ‘inus’ meaning ‘adjectival suffix implying likeness’.
aschersonianum|From the English ‘achersonianum’ / ‘Acherson’ meaning ‘commemorating a person of this name’
asiatica|From the Latin ‘asiatica’ / ‘asiaticus’ meaning ‘relating to Asia’
aspalathoides|From the Greek ‘aspalath’ / ‘aspalathos’ meaning ‘a fragrant shrub found in Greece’; and the Greek ‘oides’ / ‘oides’ meaning ‘in the form of’.
aspera|From the Latin ‘aspera’ / ‘asperus’ meaning ‘rough’
asperiflora|From the Latin ‘asperi’ / ‘asperus’ meaning ‘rough’; and the Latin ‘flora’ / ‘flos’ meaning ‘flower’.
asperulum|From the Latin ‘asper’ / ‘asperus’ meaning ‘rough’; and the Latin ‘ullum’ / ‘ullus’ meaning ‘adjectival suffix implying a faint degree of the property’.
asperum|From the Latin ‘asperum’ / ‘asperus’ meaning ‘rough’
asteriscoides|From the Latin ‘asterisc’ / ‘asteriscus’ meaning ‘small star’; and the Greek ‘oides’ / ‘oides’ meaning ‘in the form of’.
asteroides|From the Latin ‘aster’ / ‘aster’ meaning ‘star’; and the Greek ‘oides’ / ‘oides’ meaning ‘in the form of’.
astroites|From the Latin ‘astr’ / ‘aster’ meaning ‘star’; and the Greek ‘oites’ / ‘oios????’ meaning ‘single????’.
atrata|From the Latin ‘atrata’ / ‘atratus’ meaning ‘blackened’
atricapilla|From the Latin ‘atri’ / ‘ater’ meaning ‘black’; and the Latin ‘capilla’ / ‘capillum’ meaning ‘hair’.
atropurpurea|From the Latin ‘atro’ / ‘ater’ meaning ‘black’; and the Latin ‘purpurea’ / ‘purpureus’ meaning ‘purple’.
atrorubens|From the Latin ‘atro’ / ‘ater’ meaning ‘black’; and the Latin ‘rubens’ / ‘rubens’ meaning ‘becoming red’.
aurantiacus|From the Latin ‘auranti’ / ‘aurans’ meaning ‘gilding’; and the Latin ‘acus’ / ‘acus’ meaning ‘adjectival suffix. This word has been coined. It does not exist in classical Latin.’.
aurea|From the Latin ‘aurea’ / ‘aureus’ meaning ‘golden’
aureus|From the Latin ‘aureus’ / ‘aureus’ meaning ‘golden’
auritum|From the Latin ‘auritum’ / ‘auritus’ meaning ‘provided with ears’
australe|From the Latin ‘australe’ / ‘australis’ meaning ‘southern’
australis|From the Latin ‘australis’ / ‘australis’ meaning ‘southern’
autumnalis|From the Latin ‘autumnalis’ / ‘autumnalis’ meaning ‘relating to autumn’
avenacea|From the Latin ‘avenacea’ / ‘avenaceus’ meaning ‘relating to oats’
aviculare|From the Latin ‘aviculare’ / ‘avicularis’ meaning ‘relating to birds’
axillaris|From the Latin ‘axillaris’ / ‘axillaris’ meaning ‘relating to the stem’
baccans|From the Latin ‘baccans’ / ‘bearing berries’ meaning ‘’
baccifera|From the Latin ‘bacci’ / ‘bacca’ meaning ‘berry’; and the Latin ‘fera’ / ‘ferus’ meaning ‘bearing’.
bakeri|From the English ‘bakeri’ / ‘Bakeri’ meaning ‘commemorating a person of this name’
banksii|From the English ‘banksii’ / ‘Banks’ meaning ‘commemorating the eighteenth-century botanist’
barbata|From the Latin ‘barbata’ / ‘barbatus’ meaning ‘bearded’
belladonna|From the Italian ‘bella’ / ‘bella’ meaning ‘beautiful’; and the Italian ‘donna’ / ‘donna’ meaning ‘woman’.
bellendenii|From the English ‘bellendenii’ / ‘Bellenden’ meaning ‘commemorating John Bellenden Ker, 19th-century botanist’
bellidiformis|From the Latin ‘bellidi’ / ‘bellis’ meaning ‘a daisy genus’; and the Latin ‘formis’ / ‘formis’ meaning ‘in the form of’.
bellidioides|From the Latin ‘bellidi’ / ‘bellis’ meaning ‘a daisy genus’; and the Greek ‘oides’ / ‘oides’ meaning ‘in the form of’.
benghalensis|From the Hindu ‘benghal’ / ‘Bengal’ meaning ‘an Indian province’; and the Latin ‘ensis’ / ‘ensis’ meaning ‘adjectival suffix’.
bergerana|From the German??? ‘berger’ / ‘Berger’ meaning ‘commemorating a German botanist???’; and the Latin ‘ana’ / ‘anus’ meaning ‘adjectival suffix’.
bergiana|From the Swedish ‘bergi’ / ‘Bergius’ meaning ‘commemorating an 18th-century Swedish botanist’; and the Latin ‘ana’ / ‘anus’ meaning ‘adjectival suffix’.
bergianum|From the Swedish ‘bergi’ / ‘Bergius’ meaning ‘commemorating an 18th-century Swedish botanist’; and the Latin ‘anum’ / ‘anus’ meaning ‘adjectival suffix’.
betulinum|From the Latin ‘betuli’ / ‘betula’ meaning ‘birch’; and the Latin ‘inum’ / ‘inus’ meaning ‘adjectival suffix’.
bicallosum|From the Latin ‘bi’ / ‘bi’ meaning ‘two’; and the Latin ‘callosum’ / ‘callosus’ meaning ‘calloused’.
bicolor|From the Latin ‘bi’ / ‘bi’ meaning ‘two’; and the Latin ‘color’ / ‘color’ meaning ‘colour’.
bicorne|From the Latin ‘bi’ / ‘bi’ meaning ‘two’; and the Latin ‘corne’ / ‘cornis’ meaning ‘horned’.
bicornis|From the Latin ‘bi’ / ‘bi’ meaning ‘two’; and the Latin ‘cornis’ / ‘cornis’ meaning ‘horned’.
bifida|From the Latin ‘bi’ / ‘bi’ meaning ‘two’; and the Latin ‘fida’ / ‘fidus’ meaning ‘cut’.
bifidum|From the Latin ‘bi’ / ‘bi’ meaning ‘two’; and the Latin ‘fidum’ / ‘fidus’ meaning ‘cut’.
bifidus|From the Latin ‘bi’ / ‘bi’ meaning ‘two’; and the Latin ‘fidus’ / ‘fidus’ meaning ‘cut’.
biflora|From the Latin ‘bi’ / ‘bi’ meaning ‘two’; and the Latin ‘flora’ / ‘flos’ meaning ‘flower’.
bifurcus|From the Latin ‘bi’ / ‘bi’ meaning ‘two’; and the Latin ‘furcus’ / ‘furca’ meaning ‘fork’.
bipinnatum|From the Latin ‘bi’ / ‘bi’ meaning ‘two’; and the Latin ‘pinnatum’ / ‘pinnatus’ meaning ‘winged’.
bipinnatus|From the Latin ‘bi’ / ‘bi’ meaning ‘two’; and the Latin ‘pinnatus’ / ‘pinnatus’ meaning ‘winged’.
bisquamata|From the Latin ‘bis’ / ‘bis’ meaning ‘twice’; and the Latin ‘squamata’ / ‘squamata’ meaning ‘scaled’.
bituminosa|From the Latin ‘bituminosa’ / ‘bituminosus’ meaning ‘tarry’
bivalvata|From the Latin ‘bi’ / ‘bi’ meaning ‘two’; and the Latin ‘valvata’ / ‘valvatus’ meaning ‘equipped with valves’.
blancheana|From the French ‘blanche’ / ‘Blanche’ meaning ‘commemorating a woman named Blanche (French for 'white')’; and the Latin ‘ana’ / ‘anus’ meaning ‘adjectival suffix’.
bodkinii|From the English ‘bodkinii’ / ‘Bodkin’ meaning ‘commemorating a man called Bodkin’
boivinii|From the French ‘boivinii’ / ‘Boivin’ meaning ‘commemorating a 16th-century French chronicler’
bolusiana|From the English ‘bolus’ / ‘Bolus’ meaning ‘commemorating the South African botanist’; and the Latin ‘ianus’ / ‘iana’ meaning ‘adjectival suffix’.
bolusii|From the English ‘bolus’ / ‘Bolus’ meaning ‘commemorating the South African botanist’
bonaespei|From the Latin ‘bonae’ / ‘bonus’ meaning ‘good’; and the Latin ‘spei’ / ‘spes’ meaning ‘hope’.
bonaspei|From the Latin ‘bona’ / ‘bonus’ meaning ‘good’; and the Latin ‘spei’ / ‘spes’ meaning ‘hope’.
borbonica|From the French ‘borbon’ / ‘Bourbon’ meaning ‘a region in France’; and the Latin ‘ica’ / ‘icus’ meaning ‘adjectival suffix’.
borbonifolia|From the French ‘borbon’ / ‘Bourbon’ meaning ‘a region in France’; and the Latin ‘folia’ / ‘folium’ meaning ‘leaf’.
brachialis|From the Latin ‘brachialis’ / ‘brachialis’ meaning ‘relating to the arm’
brachiata|From the Latin ‘brachiata’ / ‘brachiatus’ meaning ‘branched’
brachyandra|From the Greek ‘brachy’ / ‘brachys’ meaning ‘short’; and the Greek ‘andra’ / ‘andros’ meaning ‘stamen’.
brachypetala|From the Greek ‘brachy’ / ‘brachys’ meaning ‘short’; and the Greek ‘petala’ / ‘petalon’ meaning ‘petal’.
brachyphylla|From the Greek ‘brachy’ / ‘brachys’ meaning ‘short’; and the Greek ‘phylla’ / ‘phyllon’ meaning ‘leaf’.
brachypoda|From the Greek ‘brachy’ / ‘brachys’ meaning ‘short’; and the Greek ‘poda’ / ‘pous’ meaning ‘foot’.
brachypterus|From the Greek ‘brachy’ / ‘brachys’ meaning ‘short’; and the Greek ‘pterus’ / ‘pterus’ meaning ‘wing’.
brachystachya|From the Greek ‘brachy’ / ‘brachys’ meaning ‘short’; and the Greek ‘stachya’ / ‘stakhys’ meaning ‘spike’.
bracteata|From the Latin ‘bracteata’ / ‘bracetatus’ meaning ‘provided with bracts’
bracteatum|From the Latin ‘bracteatum’ / ‘bracteatus’ meaning ‘provided with bracts’
bracteolata|From the Latin ‘bractelolata’ / ‘bracteolatus’ meaning ‘provided with bracts’
bracteolatum|From the Latin ‘bractelolatum’ / ‘bracteolatus’ meaning ‘provided with bracts’
bracteolatus|From the Latin ‘bracteolatus’ / ‘bracteolatus’ meaning ‘provided with bracts’
brehmii|From the German ‘brehmii’ / ‘Brehm’ meaning ‘commemorating a German botanist???’
brevicaulis|From the Latin ‘brevi’ / ‘brevis’ meaning ‘short’; and the Latin ‘caulis’ / ‘caulis’ meaning ‘stalk’.
brevicornu|From the Latin ‘brevi’ / ‘brevis’ meaning ‘short’; and the Latin ‘cornu’ / ‘cprnus’ meaning ‘horn’.
brevifolia|From the Latin ‘brevi’ / ‘brevis’ meaning ‘short’; and the Latin ‘folia’ / ‘folium’ meaning ‘leaf’.
brevifolium|From the Latin ‘brevi’ / ‘brevis’ meaning ‘short’; and the Latin ‘folium’ / ‘folium’ meaning ‘leaf’.
brevifolius|From the Latin ‘brevi’ / ‘brevis’ meaning ‘short’; and the Latin ‘folius’ / ‘folium’ meaning ‘leaf’.
brevipetala|From the Latin ‘brevi’ / ‘brevis’ meaning ‘short’; and the Greek ‘petalum’ / ‘petalon’ meaning ‘leaf’.
breviscapa|From the Latin ‘brevi’ / ‘brevis’ meaning ‘short’; and the Latin ‘scapa’ / ‘scapus’ meaning ‘stalk’.
brevistylum|From the Latin ‘brevi’ / ‘brevis’ meaning ‘short’; and the Greek ‘stylum’ / ‘stylon’ meaning ‘column’.
bromoides|From the Greek ‘brom’ / ‘bromos’ meaning ‘food’; and the Greek ‘oides’ / ‘oides’ meaning ‘in the form of’.
brownii|From the English ‘brownii’ / ‘Brown’ meaning ‘commemorating an eighteenth-century English botanist’
bruniades|From the Latin ‘brunia’ / ‘brunia’ meaning ‘a fynbos species’; and the Greek ‘des’ / ‘oides’ meaning ‘in the form of’.
bufonius|From the Latin ‘bufonius’ / ‘bufonius’ meaning ‘toad-like’
bulbifera|From the Latin ‘bulbi’ / ‘bulbus’ meaning ‘bulb’; and the Latin ‘fera’ / ‘ferus’ meaning ‘bearing’.
bulbillifera|From the Latin ‘bulbilli’ / ‘bulbullus’ meaning ‘a small bulb’; and the Latin ‘fera’ / ‘ferus’ meaning ‘bearing’.
bulbosa|From the Latin ‘bulbosa’ / ‘bulbosus’ meaning ‘in the form of a bulb’
bullata|From the Latin ‘bullata’ / ‘bullatus’ meaning ‘inflated’
burchellianum|From the English ‘burchelli’ / ‘Burchell’ meaning ‘commemorating the 19th-century English explorer’; and the Latin ‘anum’ / ‘anus’ meaning ‘adjectival suffix’.
burchellii|From the English ‘burchellii’ / ‘Burchell’ meaning ‘commemorating the 19th-century English explorer’
burmannia|From the Dutch ‘burmannii’ / ‘Burmann’ meaning ‘commemorating Dutch physician and botanist, Johannes Burmann (1707-1780) who specialized in plants from the Cape Colony.’
buxifolia|From the Latin ‘buxi’ / ‘buxus’ meaning ‘the box tree’; and the Latin ‘folia’ / ‘folium’ meaning ‘leaf’.
byzantina|From the Latin ‘byzantina’ / ‘byzantinus’ meaning ‘relating to Byzantium’
caerulea|From the Latin ‘caerulea’ / ‘caeruleus’ meaning ‘sky-blue’
caespitosa|From the Latin ‘caespitosa’ / ‘caespitosus’ meaning ‘tufted’
caffra|From the Latin ‘caffra’ / ‘Caffraria’ meaning ‘a former name of the Eastern Cape’
caffrorum|From the Latin ‘caffrorum’ / ‘caffri’ meaning ‘belonging to the inhabitants of the Eastern Cape’
caffrum|From the Latin ‘caffrum’ / ‘Caffraria’ meaning ‘a former name of the Eastern Cape’
cafra|From the Latin ‘cafra’ / ‘Caffraria’ meaning ‘a former name of the Eastern Cape’
carica|From the Latin ‘carica’ / ‘carica’ meaning ‘dried fig’
calcaratus|From the Latin ‘calcar’ / ‘calcar’ meaning ‘spur’; and the Latin ‘atus’ / ‘atus’ meaning ‘adjectival suffix’.
calendula|From the Latin ‘calendula’ / ‘calendulus’ meaning ‘resembling a marigold’
callosa|From the Latin ‘callosa’ / ‘callosus’ meaning ‘calloused’
calomelanos|From the Greek ‘calo’ / ‘kallos?’ meaning ‘beauty?’; and the Greek ‘melanos’ / ‘melanos’ meaning ‘black’.
calycina|From the Greek ‘calcyna’ / ‘kalkynos’ meaning ‘with a noticeable calyx’
calyptrata|From the Latin ‘calyptrata’ / ‘calyptratus’ meaning ‘equipped with a hood’
campestris|From the Latin ‘campestris’ / ‘campestris’ meaning ‘relating to the fields’
camphorata|From the Latin ‘camphorata’ / ‘camphoratus’ meaning ‘having the quality of camphor’
camphoratus|From the Latin ‘camphoratus’ / ‘camphoratus’ meaning ‘having the quality of camphor’
canaliculata|From the Latin ‘canaliculata’ / ‘canaliculatus’ meaning ‘channelled’
canaliculatus|From the Latin ‘canaliculatus’ / ‘canaliculatus’ meaning ‘channelled’
canariensis|From the Latin ‘canarensis’ / ‘Canary Islands’ meaning ‘pertaining to the Canary Islands’
cancellata|From the Latin ‘cancellata’ / ‘cancellatus’ meaning ‘trellised’
cancellatus|From the Latin ‘cancellatus’ / ‘cancellatus’ meaning ‘trellised’
candens|From the Latin ‘candens’ / ‘candens’ meaning ‘glowing’
candicans|From the Latin ‘candicans’ / ‘candicans’ meaning ‘increasing in glow’
candidum|From the Latin ‘candidum’ / ‘candidus’ meaning ‘radiant’
candolleana|From the Swiss ‘candolleana’ / ‘De Candolle’ meaning ‘commemorating Swiss botanist Augustin Pyramus De Candolle’
canescens|From the Latin ‘canescens’ / ‘canescens’ meaning ‘becoming white’
capense|From the Latin ‘capense’ / ‘Cape’ meaning ‘pertaining to the southern region of South Africa’
capensis|From the Latin ‘capensis’ / ‘Cape’ meaning ‘pertaining to the southern region of South Africa’
capillacea|From the Latin ‘capillacea’ / ‘capillaceus’ meaning ‘equipped with hairs’
capillaceum|From the Latin ‘capillaceum’ / ‘capillaceus’ meaning ‘equipped with hairs’
capillare|From the Latin ‘capillare’ / ‘capillaris’ meaning ‘hairy’
capillaris|From the Latin ‘capillaris’ / ‘capillaris’ meaning ‘hairy’
capillifolia|From the Latin ‘capilli’ / ‘capillum’ meaning ‘hair’; and the Latin ‘folia’ / ‘folium’ meaning ‘leaf’.
capillus-veneris|From the Latin ‘capillus’ / ‘capillum’ meaning ‘hair’; and the Latin ‘Veneris’ / ‘Venus’ meaning ‘of Venus’.
capitata|From the Latin ‘capitata’ / ‘capitatus’ meaning ‘equipped with a head’
capitatum|From the Latin ‘capitatum’ / ‘capitatus’ meaning ‘equipped with a head’
capitatus|From the Latin ‘capitatus’ / ‘capitatus’ meaning ‘equipped with a head’
capitella|From the Latin ‘capitella’ / ‘capitelllum’ meaning ‘little head’
capitellata|From the Latin ‘capitellata’ / ‘capitellatus’ meaning ‘equipped with a  little head’
capituliflorum|From the Latin ‘capituli’ / ‘capitellum’ meaning ‘little head’; and the Latin ‘florum’ / ‘flos’ meaning ‘flower’.
caprina|From the Latin ‘caprina’ / ‘caprinus’ meaning ‘resembling a goat’
caput-medusae|From the Latin ‘caput’ / ‘caput’ meaning ‘head’; and the Latin ‘medusae’ / ‘Medusa’ meaning ‘the gorgon with snakes for hair’.
carinata|From the Latin ‘carinata’ / ‘carinatus’ meaning ‘equipped with a keel’
carinatum|From the Latin ‘carinatum’ / ‘carinatus’ meaning ‘equipped with a keel’
carinatus|From the Latin ‘carinatus’ / ‘carinatus’ meaning ‘equipped with a keel’
carneum|From the Latin ‘carneum’ / ‘carneus’ meaning ‘flesh-coloured’
carneus|From the Latin ‘carneus’ / ‘carneus’ meaning ‘flesh-coloured’
carnosa|From the Latin ‘carnosa’ / ‘carnosus’ meaning ‘fleshy’
carnosum|From the Latin ‘carnosum’ / ‘carnosus’ meaning ‘fleshy’
caroliniana|From the Latin ‘carolini’ / ‘Carolus’ meaning ‘Latin form of Charles’; and the Latin ‘ana’ / ‘anus’ meaning ‘adjectival suffix’.
carroensis|From the Nama ‘carroensis’ / ‘Karoo’ meaning ‘relating to the Karoo’
caruifolia|From the Greek ‘carui’ / ‘karyos’ meaning ‘clove’; and the Latin ‘folia’ / ‘folium’ meaning ‘leaf’.
caryophyllacea|From the Greek ‘caryo’ / ‘karyos’ meaning ‘clove’; and the Latin ‘phyll’ / ‘phyllon’ meaning ‘leaf’.
caterviflora|From the Latin ‘catervi’ / ‘caterva’ meaning ‘crowd’; and the Latin ‘flora’ / ‘flos’ meaning ‘flower’.
catharticus|From the Greek ‘catharicus’ / ‘kathartikos’ meaning ‘purging’
catholicum|From the Latin ‘catholicum’ / ‘catholicus’ meaning ‘universal’
cepacea|From the Latin ‘cepacea’ / ‘capaea’ meaning ‘portulacca’; and the Latin ‘ea’ / ‘eus’ meaning ‘adjectival suffix’.
cephalantha|From the Greek ‘cephal’ / ‘kephale’ meaning ‘head’; and the Greek ‘antha’ / ‘anthos’ meaning ‘flower’.
cephalophorum|From the Greek ‘cephal’ / ‘kephale’ meaning ‘head’; and the Greek ‘phorum’ / ‘phoros’ meaning ‘bearing’.
cephalotes|From the Greek ‘cephal’ / ‘kephale’ meaning ‘head’; and the Greek ‘otes’ / ‘????otis’ meaning ‘ear’.
cerinthoides|From the Greek ‘cerinth’ / ‘kerinthe’ meaning ‘honeywort’; and the Greek ‘oides’ / ‘oides’ meaning ‘in the form of’.
cernua|From the Latin ‘cernua’ / ‘cernuus’ meaning ‘drooping’
cernuum|From the Latin ‘carnuum’ / ‘cernuus’ meaning ‘drooping’
chamaedryfolium|From the Greek ‘chamae’ / ‘khamai’ meaning ‘terrestrial’; and the Greek ‘dry’ / ‘dryas’ meaning ‘tree’.
chamelaeagnea|From the Greek ‘chamelaeag’ / ‘khamaileon’ meaning ‘chameleon’; and the Latin ‘nea’ / ‘neus’ meaning ‘adjectival suffix’.
cheiranthus|From the Greek ‘cheir’ / ‘kheiros’ meaning ‘hand’; and the Greek ‘anthus’ / ‘anthos’ meaning ‘flower’.
chenopoda|From the Greek ‘cheno’ / ‘khenos’ meaning ‘goose’; and the Greek ‘poda’ / ‘pous’ meaning ‘foot’.
chlamydophylla|From the Greek ‘chlamydo’ / ‘khlamys’ meaning ‘an outer garment’; and the Greek ‘phylla’ / ‘phyllon’ meaning ‘leaf’.
chrysanthemoides|From the Greek ‘chrys’ / ‘khrysos’ meaning ‘gold’; and the Greek ‘anthemo’ / ‘anthemon’ meaning ‘flower’.
ciliaris|From the Latin ‘ciliaris’ / ‘ciliaris’ meaning ‘relating to the eyelash or fine hairs’
ciliata|From the Latin ‘ciliata’ / ‘ciliatus’ meaning ‘equipped with fine hairs’
ciliatum|From the Latin ‘ciliatum’ / ‘ciliatus’ meaning ‘equipped with fine hairs’
ciliolata|From the Latin ‘ciliolata’ / ‘ciliolatus’ meaning ‘equipped with fine hairs’
cincinnata|From the Latin ‘cincinnata’ / ‘cincinnatus’ meaning ‘equipped with curly hair’
cincta|From the Latin ‘cincta’ / ‘cinctus’ meaning ‘girdled’
cinerea|From the Latin ‘cinerea’ / ‘cinereus’ meaning ‘relating to ashes’
cinereus|From the Latin ‘cinereus’ / ‘cinereus’ meaning ‘relating to ashes’
cinnamomea|From the Latin ‘cinnamomea’ / ‘cinnemomeus’ meaning ‘cinnamon-coloured’
circaeoides|From the Latin ‘circcae’ / ‘circaea’ meaning ‘plant used as a charm’; and the Greek ‘oides’ / ‘oides’ meaning ‘in the form of’.
circumflexa|From the Latin ‘circum’ / ‘circum’ meaning ‘around’; and the Latin ‘flexa’ / ‘flexus’ meaning ‘bent’.
cistiflora|From the Latin ‘cisti’ / ‘cistus’ meaning ‘the rock rose’; and the Latin ‘flora’ / ‘flos’ meaning ‘flower’.
clandestina|From the Latin ‘clandestina’ / ‘clandestinus’ meaning ‘secret’
clandestinum|From the Latin ‘clandestinum’ / ‘clandestinus’ meaning ‘secret’
clavata|From the Latin ‘clavata’ / ‘clavatus’ meaning ‘club-shaped’
clavisepala|From the Latin ‘clavi’ / ‘clava’ meaning ‘club’; and the Latin ‘sepala’ / ‘sepalum’ meaning ‘sepal’.
coarctata|From the Latin ‘co’ / ‘cum’ meaning ‘together’; and the Latin ‘arctata’ / ‘arctatus’ meaning ‘contracted’.
coccinea|From the Latin ‘coccinea’ / ‘coccineus’ meaning ‘scarlet’
coccineus|From the Latin ‘coccineus’ / ‘coccineus’ meaning ‘scarlet’
coerulescens|From the Latin ‘coerulescens’ / ‘caerulescens’ meaning ‘turning blue’
cognata|From the Latin ‘cognata’ / ‘cognatus’ meaning ‘related’
coleura|From the Greek ‘coleura’ / ‘koleuros’ meaning ‘relating to the thigh bone’
collina|From the Latin ‘collina’ / ‘collinus’ meaning ‘relating to hilly country’
colorata|From the Latin ‘colorata’ / ‘coloratus’ meaning ‘coloured’
columbaria|From the Latin ‘columbaria’ / ‘columbarius’ meaning ‘relating to doves or columbines’
coma-aurea|From the Latin ‘coma’ / ‘coma’ meaning ‘hair’; and the Latin ‘aurea’ / ‘aureus’ meaning ‘golden’.
commixta|From the Latin ‘commixta’ / ‘commixtus’ meaning ‘mixed together’
communis|From the Latin ‘communis’ / ‘communis’ meaning ‘common’
commutata|From the Latin ‘commutata’ / ‘commutatus’ meaning ‘changed’
commutatum|From the Latin ‘commutatum’ / ‘commutatus’ meaning ‘changed’
commutatus|From the Latin ‘commutatus’ / ‘commutatus’ meaning ‘changed’
comosa|From the Latin ‘comosa’ / ‘comosus’ meaning ‘bearing locks’
compacta|From the Latin ‘compacta’ / ‘compactus’ meaning ‘compacted’
compar|From the Latin ‘compar’ / ‘compar’ meaning ‘similar’
compressa|From the Latin ‘compressa’ / ‘compressus’ meaning ‘compressed’
compressus|From the Latin ‘compressus’ / ‘compressus’ meaning ‘compressed’
comptonii|From the English ‘comptonii’ / ‘Compton’ meaning ‘commemorating the botanist Compton’
concatenata|From the Latin ‘con’ / ‘cum’ meaning ‘together’; and the Latin ‘catenata’ / ‘catenatus’ meaning ‘chained’.
conferta|From the Latin ‘con’ / ‘cum’ meaning ‘together’; and the Latin ‘ferta’ / ‘fertus’ meaning ‘brought’.
confluens|From the Latin ‘con’ / ‘cum’ meaning ‘together’; and the Latin ‘fluens’ / ‘fluens’ meaning ‘flowing’.
conforme|From the Latin ‘conforme’ / ‘conformis’ meaning ‘symmetrical’
congestus|From the Latin ‘congestus’ / ‘congestus’ meaning ‘piled  up’
conica|From the Latin ‘conica’ / ‘conicus’ meaning ‘cone-shaped’
conicum|From the Latin ‘conicum’ / ‘conicus’ meaning ‘cone-shaped’
coniferum|From the Latin ‘coniferum’ / ‘coniferus’ meaning ‘bearing cones’
connivens|From the Latin ‘connivens’ / ‘connivens’ meaning ‘heavy with sleep’
conocarpodendron|From the Greek ‘cono’ / ‘konos’ meaning ‘cone’; and the Greek ‘carpo’ / ‘karpos’ meaning ‘fruit’.
contaminata|From the Latin ‘contaminata’ / ‘contaminatus’ meaning ‘contaminated’
contorta|From the Latin ‘contorta’ / ‘contortus’ meaning ‘contorted’
contortus|From the Latin ‘contortus’ / ‘contortus’ meaning ‘contorted’
contracta|From the Latin ‘contracta’ / ‘contractus’ meaning ‘contracted’
cooperi|From the English ‘cooperi’ / ‘Cooper’ meaning ‘commemorating the botanist Cooper’
coracana|From the Latin ‘coracana (spelling??)’ / ‘coracinus’ meaning ‘black’
cordata|From the Latin ‘cordata’ / ‘cordatus’ meaning ‘heart-shaped’
cordatum|From the Latin ‘cordatum’ / ‘cordatus’ meaning ‘heart-shaped’
cordatus|From the Latin ‘cordatus’ / ‘cordatus’ meaning ‘heart-shaped’
cordifolia|From the Latin ‘cordi’ / ‘cor’ meaning ‘heart’; and the Latin ‘folia’ / ‘folium’ meaning ‘leaf’.
cordifolium|From the Latin ‘cordi’ / ‘cor’ meaning ‘heart’; and the Latin ‘folium’ / ‘folium’ meaning ‘leaf’.
cordifolius|From the Latin ‘cordi’ / ‘cor’ meaning ‘heart’; and the Latin ‘folius’ / ‘folium’ meaning ‘leaf’.
cordiforme|From the Latin ‘cordi’ / ‘cor’ meaning ‘heart’
coricacea|From the Latin ‘cori’ / ‘coris’ meaning ‘thick and leathery’; and the Latin ‘acea’ / ‘aceus’ meaning ‘adjectival suffix’.
corifolia|From the Latin ‘cori’ / ‘coris’ meaning ‘thick and leathery’; and the Latin ‘folia’ / ‘folium’ meaning ‘leaf’.
coriifolium|From the Latin ‘cori’ / ‘coris’ meaning ‘thick and leathery’
corneolus|From the Latin ‘corneolus’ / ‘corneolus’ meaning ‘horny’
corniculata|From the Latin ‘corniculata’ / ‘corniculatus’ meaning ‘equipped with horns’
cornuta|From the Latin ‘cornuta’ / ‘cornutus’ meaning ‘horned’
coronata|From the Latin ‘coronata’ / ‘coronatus’ meaning ‘crowned’
coronopifolia|From the Latin ‘coronopi’ / ‘coronopus’ meaning ‘the plant called crowfoot’; and the Latin ‘folia’ / ‘folium’ meaning ‘leaf’.
coronopus|From the Latin ‘coronopus’ / ‘coronopus’ meaning ‘the plant called crowfoot’
corymbosa|From the Latin ‘corymbosa’ / ‘corymbosus’ meaning ‘bearing clusters’
cracca|From the Latin ‘cracca’ / ‘cracca’ meaning ‘vetch’
crassifolia|From the Latin ‘crassi’ / ‘crassus’ meaning ‘thick’; and the Latin ‘folia’ / ‘folium’ meaning ‘leaf’.
crassulifolius|From the Latin ‘crassuli’ / ‘crassula’ meaning ‘the plant called crassula’; and the Latin ‘folius’ / ‘folium’ meaning ‘leaf’.
crenata|From the Latin ‘crenata’ / ‘crenatus’ meaning ‘battlemented’
cretica|From the Latin ‘cretica’ / ‘creticus’ meaning ‘relating to Crete’
crinalis|From the Latin ‘crinalis’ / ‘crinalis’ meaning ‘relating to hair’
crinifolia|From the Latin ‘crini’ / ‘crinum’ meaning ‘hair’; and the Latin ‘folia’ / ‘folium’ meaning ‘leaf’.
crispa|From the Latin ‘crispa’ / ‘crispus’ meaning ‘curled’
crispum|From the Latin ‘crispum’ / ‘crispus’ meaning ‘curled’
crispus|From the Latin ‘crispus’ / ‘crispus’ meaning ‘curled’
cristata|From the Latin ‘cristata’ / ‘cristatus’ meaning ‘tufted’
cristiflora|From the Latin ‘cristi’ / ‘crista’ meaning ‘tuft’; and the Latin ‘flora’ / ‘flos’ meaning ‘flower’.
crithmifolia|From the Greek ‘crithmi’ / ‘krithe’ meaning ‘barley’; and the Latin ‘folia’ / ‘folium’ meaning ‘leaf’.
crocea|From the Latin ‘crocea’ / ‘croceus’ meaning ‘saffron-coloured’
cruciata|From the Latin ‘cruciata’ / ‘cruciatus’ meaning ‘cross-shaped’
cruciferum|From the Latin ‘cruci’ / ‘crux’ meaning ‘cross’; and the Latin ‘ferum’ / ‘fertus’ meaning ‘bearing’.
crusgalli|From the Latin ‘crus’ / ‘crus’ meaning ‘leg’; and the  Latin ‘galli’ / ‘gallus’ meaning ‘cock’.
crystallinum|From the Latin ‘crystallinum’ / ‘crystallinus’ meaning ‘crystalline’
cucullata|From the Latin ‘cucullata’ / ‘cucullatus’ meaning ‘hooded’
cucullatum|From the Latin ‘cucullatum’ / ‘cucullatus’ meaning ‘hooded’
cucullatus|From the Latin ‘cucullatus’ / ‘cucullatus’ meaning ‘hooded’
cuneata|From the Latin ‘cuneata’ / ‘cuneatus’ meaning ‘wedge-shaped’
cuneifolia|From the Latin ‘cunei’ / ‘cunea’ meaning ‘wedge’; and the Latin ‘folia’ / ‘folium’ meaning ‘leaf’.
cunonius|From the Dutch ‘cunonius’ / ‘Cuno’ meaning ‘commemorating an 18th-century Dutch botanist’
cupaniana|From the Latin ‘cupani’ / ‘cupa?’ meaning ‘cask?’; and the Latin ‘iana’ / ‘ianus’ meaning ‘adjectival suffix’.
curculioides|From the Latin ‘curculi’ / ‘curculio’ meaning ‘pertaining to weevils’; and the Greek ‘oides’ / ‘oides’ meaning ‘in the form of’.
curvifolia|From the Latin ‘curvi’ / ‘curvus’ meaning ‘curved’; and the Latin ‘folia’ / ‘folium’ meaning ‘leaf’.
curvipetala|From the Latin ‘curvi’ / ‘curvus’ meaning ‘curved’; and the Greek ‘petala’ / ‘petalon’ meaning ‘petal’.
curviramis|From the Latin ‘curvi’ / ‘curvus’ meaning ‘curved’; and the Latin ‘ramis’ / ‘ramus’ meaning ‘branch’.
curvirostris|From the Latin ‘curvi’ / ‘curvus’ meaning ‘curved’; and the Latin ‘rostris’ / ‘rostum’ meaning ‘beak’.
curvula|From the Latin ‘curvula’ / ‘curvulus’ meaning ‘somewhat curved’
cuspidata|From the Latin ‘cuspidata’ / ‘cuspidatus’ meaning ‘pointed’
cyanoides|From the Greek ‘cyan’ / ‘kyanos’ meaning ‘blue-green’; and the Greek ‘oides’ / ‘oides’ meaning ‘tending toward’.
cyathuloides|From the Greek ‘cyatha’ / ‘kyatholos’ meaning ‘small drinking cup’; and the Greek ‘oides’ / ‘oides’ meaning ‘in the form of’.
cyclops|From the Greek ‘cyc’ / ‘kuklos’ meaning ‘circle’; and the Greek ‘ops’ / ‘ops’ meaning ‘eye’.
cylindrica|From the Latin ‘cylindrica’ / ‘cylindricus’ meaning ‘cylindrical’
cylindriflorum|From the Latin ‘cylindri’ / ‘cylindrus’ meaning ‘cylinder’; and the Latin ‘florum’ / ‘flos’ meaning ‘flower’.
cymbalariae|From the Latin ‘cymbalar’ / ‘cymbalaris’ meaning ‘a plant called the cotyledon’; and the Latin ‘iae’ / ‘ia’ meaning ‘adjectival suffix’.
cymbalarioides|From the Latin ‘cynbalari’ / ‘cymbalaris’ meaning ‘a plant called the cotyledon’; and the Greek ‘oides’ / ‘oides’ meaning ‘in the form of’.
cymbifolia|From the Greek ‘cymbi’ / ‘kymbe’ meaning ‘boat’; and the Latin ‘folia’ / ‘folium’ meaning ‘leaf’.
cymbiformis|From the Greek ‘cymbi’ / ‘kymbe’ meaning ‘boat’; and the Latin ‘formis’ / ‘formis’ meaning ‘in the form of’.
cymosa|From the Greek ‘cym’ / ‘kyma’ meaning ‘wave’; and the Latin ‘osa’ / ‘osus’ meaning ‘adjectival suffix’.
cymosum|From the Greek ‘cym’ / ‘kyma’ meaning ‘wave’; and the Latin ‘osum’ / ‘osus’ meaning ‘adjectival suffix’.
cynaroides|From the Greek ‘cyna’ / ‘kynara’ meaning ‘globe artichoke’; and the Greek ‘oides’ / ‘oides’ meaning ‘in the form of’.
cyperoides|From the Greek ‘cyper’ / ‘kyperos’ meaning ‘sedge’; and the Greek ‘oides’ / ‘oides’ meaning ‘in the form of’.
cyrilliflora|From the Greek ‘cyrilli’ / ‘kyrillos?’ meaning ‘lordly?’; and the Greek ‘oides’ / ‘oides’ meaning ‘in the form of’.
cytisoides|From the Greek ‘cytis’ / ‘cytisos’ meaning ‘the plant called broom’; and the Greek ‘oides’ / ‘oides’ meaning ‘in the form of’.
dactylon|From the Greek ‘dactylon’ / ‘daktylos’ meaning ‘finger’
dasyanthum|From the Greek ‘dasy’ / ‘dasos’ meaning ‘rough’; and the Greek ‘anthum’ / ‘anthos’ meaning ‘flower’.
dealbatum|From the Latin ‘dealbatum’ / ‘dealbatus’ meaning ‘white-washed’
debilis|From the Latin ‘debilis’ / ‘debilis’ meaning ‘fragile’
decipiens|From the Latin ‘decipiens’ / ‘decipiens’ meaning ‘deceiving’
decora|From the Latin ‘decora’ / ‘decorus’ meaning ‘beautiful’
decumbens|From the Latin ‘decumbens’ / ‘decumbens’ meaning ‘lying down’
decurrens|From the Latin ‘decurrens’ / ‘decurrens’ meaning ‘running down’
dejecta|From the Latin ‘dejecta’ / ‘dejectus’ meaning ‘cast down’
demissa|From the Latin ‘demissa’ / ‘demissus’ meaning ‘sent down’
densiflora|From the Latin ‘densi’ / ‘densus’ meaning ‘dense’; and the Latin ‘flora’ / ‘flos’ meaning ‘flower’.
densiflorum|From the Latin ‘densi’ / ‘densus’ meaning ‘dense’; and the Latin ‘florum’ / ‘flos’ meaning ‘flower’.
dentata|From the Latin ‘dentata’ / ‘dentatus’ meaning ‘equipped with teeth’
denudatus|From the Latin ‘debudatus’ / ‘denudatus’ meaning ‘stripped bare’
depressa|From the Latin ‘depressa’ / ‘depressus’ meaning ‘pushed down’
deusta|From the Latin ‘deusta’ / ‘deustus’ meaning ‘severely scorched’
deustum|From the Latin ‘deustum’ / ‘deustus’ meaning ‘severely scorched’
diabolica|From the Latin ‘diabolica’ / ‘diabolicus’ meaning ‘devilish’
diandrus|From the Greek ‘di’ / ‘di’ meaning ‘two’; and the Greek ‘andrus’ / ‘andros’ meaning ‘stamen’.
dichotoma|From the Greek ‘dichotoma’ / ‘dichotomia’ meaning ‘a division into two’
difformis|From the Latin ‘difformis’ / ‘difformis’ meaning ‘deformed’
diffusa|From the Latin ‘diffusa’ / ‘diffusus’ meaning ‘widespread’
digitata|From the Latin ‘digitata’ / ‘digitatus’ meaning ‘equipped with fingers’
dimidiata|From the Latin ‘dimiditata’ / ‘dimidiatus’ meaning ‘halved’
dioica|From the Greek ‘di’ / ‘di’ meaning ‘two’; and the Greek ‘oikos’ / ‘’ meaning ‘’.
diosmifolia|From the Greek ‘diosmi’ / ‘diosmos’ meaning ‘a plant belonging to the Rutaceae’; and the Latin ‘folia’ / ‘folium’ meaning ‘leaf’.
discolor|From the Latin ‘discolor’ / ‘discolor’ meaning ‘variegated’
dispar|From the Latin ‘dispar’ / ‘dispar’ meaning ‘dissimilar’
dissecta|From the Latin ‘dissecta’ / ‘dissectus’ meaning ‘dissected’
distachya|From the Greek ‘di’ / ‘di’ meaning ‘two’; and the Greek ‘stachya’ / ‘stachys’ meaning ‘spike’.
distachyon|From the Greek ‘di’ / ‘di’ meaning ‘two’; and the Greek ‘stachyon’ / ‘stachys’ meaning ‘spike’.
distachyos|From the Greek ‘di’ / ‘di’ meaning ‘two’; and the Greek ‘stachyos’ / ‘stachys’ meaning ‘spike’.
disticha|From the Greek ‘di’ / ‘di’ meaning ‘two’; and the Greek ‘sticha’ / ‘stichos’ meaning ‘row’.
distichum|From the Greek ‘di’ / ‘di’ meaning ‘two’; and the Greek ‘stichum’ / ‘stichos’ meaning ‘row’.
distichus|From the Greek ‘di’ / ‘di’ meaning ‘two’; and the Greek ‘stichus’ / ‘stiichos’ meaning ‘row’.
distorta|From the Latin ‘distorta’ / ‘distortus’ meaning ‘distorted’
divaricata|From the Latin ‘divaricata’ / ‘divaricatus’ meaning ‘divergent’
divergens|From the Latin ‘divergens’ / ‘divergens’ meaning ‘diverging’
diversifolia|From the Latin ‘diversi’ / ‘diversus’ meaning ‘diverse’; and the Latin ‘folia’ / ‘folium’ meaning ‘leaf’.
dodecandra|From the Greek ‘dodeca’ / ‘dodeko’ meaning ‘twelve’; and the Greek ‘andra’ / ‘andros’ meaning ‘anther’.
dodii|From the English ‘dodii’ / ‘Dodd’ meaning ‘commemorating a South African botanist’
draconis|From the Latin ‘draconis’ / ‘draconis’ meaning ‘dragon-like’
dregeana|From the German ‘dregeanus’ / ‘Drege’ meaning ‘commemorates the brothers Carl Friedrich Drege (1791-1867) and Johann Franz Drege (1794-1881) of Huguenot ancestry.  Prodigious collectors in the Cape.’
dregeanum|From the German ‘dregeanum’ / ‘Drege’ meaning ‘commemorates the brothers Carl Friedrich Drege (1791-1867) and Johann Franz Drege (1794-1881) of Huguenot ancestry.  Prodigious collectors in the Cape.’
dregeanus|From the German ‘dregeanus’ / ‘Drege’ meaning ‘commemorates the brothers Carl Friedrich Drege (1791-1867) and Johann Franz Drege (1794-1881) of Huguenot ancestry.  Prodigious collectors in the Cape.’
dregei|From the German ‘dregei’ / ‘Drege’ meaning ‘commemorates the brothers Carl Friedrich Drege (1791-1867) and Johann Franz Drege (1794-1881) of Huguenot ancestry.  Prodigious collectors in the Cape.’
dubia|From the Latin ‘dubia’ / ‘dubius’ meaning ‘doubtful’
dubius|From the Latin ‘dubius’ / ‘dubius’ meaning ‘doubtful’
dumosa|From the Latin ‘domosus’ / ‘dumosa’ meaning ‘bushy’
dunensis|From the Middle Dutch ‘dun’ / ‘dune’ meaning ‘dune’; and the Latin ‘ensis’ / ‘ensis’ meaning ‘adjectival suffix’.
ebracteatum|From the Latin ‘e’ / ‘ex’ meaning ‘lacking’; and the Latin ‘bracteatum’ / ‘bracteatus’ meaning ‘equipped with bracts’.
eburnea|From the Latin ‘eburnea’ / ‘eburneus’ meaning ‘made of ivory’
ecalcarata|From the Latin ‘e’ / ‘ex’ meaning ‘lacking’; and the Latin ‘calcarata’ / ‘calcarata’ meaning ‘equipped with spurs’.
echinatum|From the Latin ‘echinatum’ / ‘echinatus’ meaning ‘resembling a hedgehog’
echinatus|From the Latin ‘echinatus’ / ‘echinatus’ meaning ‘resembling a hedgehog’
ecklonea|From the German ‘ecklonea’ / ‘Ecklon’ meaning ‘commemorating a botanist of this name’
eckloniana|From the German ‘eckloniana’ / ‘Ecklon’ meaning ‘commemorating a botanist of this name’
ecklonianum|From the German ‘ecklonianum’ / ‘Ecklon’ meaning ‘commemorating a botanist of this name’
ecklonii|From the German ‘ecklonii’ / ‘Ecklon’ meaning ‘commemorating a botanist of this name’
edulis|From the Latin ‘edulis’ / ‘edulis’ meaning ‘edible’
effusus|From the Latin ‘effusus’ / ‘effusus’ meaning ‘effuse, abundant’
egregius|From the Latin ‘egregius’ / ‘egregius’ meaning ‘distinguished’
elata|From the Latin ‘elata’ / ‘elatus’ meaning ‘high’
elatior|From the Latin ‘elatior’ / ‘elatior’ meaning ‘higher’
elegans|From the Latin ‘elegans’ / ‘elegans’ meaning ‘elegant’
eleocharis|From the Greek ‘eleo’ / ‘eleios’ meaning ‘relating to a marsh’; and the Greek ‘charis’ / ‘khare’ meaning ‘grace’.
ellaphieae|From the Greek  ‘ellaphiae’ / ‘Elaphia’ meaning ‘commemorating the botanical artist Elaphia Ward-Hillhorst’
elongata|From the Latin ‘elongata’ / ‘elongatus’ meaning ‘elongated’
elongatum|From the Latin ‘elongatum’ / ‘elongatus’ meaning ‘elongated’
elsiae|From the German ‘elsiae’ / ‘Adalheidis’ meaning ‘commemorating the botanist Elsie Esterhuysen’
emarginata|From the Latin ‘emarginata’ / ‘emarginatus’ meaning ‘missing a part of the margin’
emarginatus|From the Latin ‘emarginatus’ / ‘emarginatus’ meaning ‘missing a part of the margin’
empetrina|From the Greek ‘empetrina’ / ‘empetros’ meaning ‘growing amidst rocks’
enerve|From the Latin ‘enerve’ / ‘enervis’ meaning ‘lacking vitality’
equisetinum|From the Latin ‘equi’ / ‘equus’ meaning ‘horse’; and the Latin ‘setinum’ / ‘setinus’ meaning ‘equipped with hairs’.
erecta|From the Latin ‘erecta’ / ‘erectus’ meaning ‘’
erectum|From the Latin ‘erectum’ / ‘erectus’ meaning ‘’
erectus|From the Latin ‘erectus’ / ‘erectus’ meaning ‘’
eriantha|From the Greek ‘eri’ / ‘erion’ meaning ‘wool’; and the Greek ‘antha’ / ‘anthos’ meaning ‘flower’.
ericifolia|From the Latin ‘erici’ / ‘erica’ meaning ‘heath’; and the Latin ‘folia’ / ‘folium’ meaning ‘leaf’.
ericifolium|From the Latin ‘erici’ / ‘erica’ meaning ‘heath’; and the Latin ‘folia’ / ‘folium’ meaning ‘leaf’.
ericoides|From the Latin ‘eric’ / ‘erica’ meaning ‘heath’; and the Greek ‘oides’ / ‘oides’ meaning ‘in the form of’.
erinus|From the Latin ‘erinus’ / ‘erinaceus’ meaning ‘resembling a hedgehog’
eriocephalina |From the Greek ‘erio’ / ‘erion’ meaning ‘wool’; and the Greek ‘cephal’ / ‘kephale’ meaning ‘head’.
eriostoma|From the Greek ‘erio’ / ‘erion’ meaning ‘wool’; and the Greek ‘stoma’ / ‘stoma’ meaning ‘leaf-pore’.
erosus|From the Latin ‘erosus’ / ‘erosus’ meaning ‘eroded’
erythrina  Link|From the Greek ‘erythrina’ / ‘erythros’ meaning ‘blood-red’
esculentus|From the Latin ‘esculentus’ / ‘esculentus’ meaning ‘edible’
etheliae|From the Old English ‘etheliae’ / ‘Ethel’ meaning ‘commemorating a botanist with this first name’
etusa|From the Latin ‘etusa’ / ‘etusu’ meaning ‘beaten flat’
eucliforme|From the Greek ‘eucli’ / ‘euclea’ meaning ‘a certain tree’; and the Latin ‘forme’ / ‘formis’ meaning ‘in the form of’.
eucomoides|From the Greek ‘eucom’ / ‘eucomis’ meaning ‘what is commonly called the pineapple flower’; and the Greek ‘oides’ / ‘oides’ meaning ‘in the form of’.
eucomus|From the Greek ‘eu’ / ‘eu’ meaning ‘prefix signifying excellence’; and the Greek ‘comis’ / ‘kome’ meaning ‘hair’.
euphrasioides|From the Greek ‘euphrasi’ / ‘euphrasia’ meaning ‘cow-wheat’; and the Greek ‘oides’ / ‘oides’ meaning ‘in the form of’.
europaea|From the Latin ‘europaea’ / ‘europaeus’ meaning ‘pertaining to Europe’
exacoides|; and the Greek ‘oides’ / ‘oides’ meaning ‘in the form of’.
exasperata|From the Latin ‘exasperata’ / ‘exasperatus’ meaning ‘irritated’
excelsa|From the Latin ‘excelsa’ / ‘excelsus’ meaning ‘high’
excisa|From the Latin ‘excisa’ / ‘excisus’ meaning ‘cut out’
excisum|From the Latin ‘excisum’ / ‘excisus’ meaning ‘cut out’
exiguum|From the Latin ‘exiguum’ / ‘exiguus’ meaning ‘sparse’
exilis|From the Latin ‘exilis’ / ‘exilis’ meaning ‘banished ’
eximia|From the Latin ‘eximia’ / ‘eximius’ meaning ‘distinguished’
exleeana|From the English ‘exleeana’ / ‘Lee’ meaning ‘commemorating a plant merchant of this name’
explanatus|From the Latin ‘explanatus’ / ‘explanatus’ meaning ‘spread flat’
exuvialis|From the Latin ‘exuvialis’ / ‘exuvialis’ meaning ‘appearing to have shed skin’
exuviata|From the Latin ‘exuviata’ / ‘exuviatus’ meaning ‘having shed skin’
fairii|From the English ‘fairii’ / ‘Fair’ meaning ‘commemorating the botanist C B Fair’
falcata|From the Latin ‘falcata’ / ‘falcatus’ meaning ‘sickled’
falcatula|From the Latin ‘falcatula’ / ‘falcatula’ meaning ‘a little sickle’
falcatus|From the Latin ‘falcatus’ / ‘falcatus’ meaning ‘sickled’
falciformis|From the Latin ‘falci’ / ‘falx’ meaning ‘sickle’; and the Latin ‘formis’ / ‘formis’ meaning ‘in the form of’.
fallax|From the Latin ‘fallax’ / ‘fallax’ meaning ‘deceptive’
farinosus|From the Latin ‘farinosus’ / ‘farinosus’ meaning ‘floury’
fasciata|From the Latin ‘fasciata’ / ‘fasciatus’ meaning ‘bundled’
fascicularis|From the Latin ‘fascicularis’ / ‘fascicularis’ meaning ‘relating to bundled faggots’
fasciculata|From the Latin ‘fasciculata’ / ‘fasciculatus’ meaning ‘bundled like faggots’
fasciflora|From the Latin ‘fasci’ / ‘fascis’ meaning ‘a bundle of faggots’; and the Latin ‘flora’ / ‘flos’ meaning ‘flower’.
fastigata|From the Latin ‘fastigata’ / ‘fastigata’ meaning ‘sharpened’
fastigiata|From the Latin ‘fastigiata’ / ‘fastigiatus’ meaning ‘gabled’
fastigiatus|From the Latin ‘fastigiatus’ / ‘fastigiatus’ meaning ‘gabled’
fastigiosa|From the Latin ‘fastigiosa’ / ‘fastigiosus’ meaning ‘gabled’
fatua|From the Latin ‘fatua’ / ‘fatuus’ meaning ‘clumsy’
favosa|From the Latin ‘favosa’ / ‘favosus’ meaning ‘resembling honeycomb’
fenestrata|From the Latin ‘fenestrata’ / ‘fenestratus’ meaning ‘equipped with windows’
ferocissimum|From the Latin ‘ferocissimum’ / ‘ferocissimus’ meaning ‘most ferocious’
ferrea|From the Latin ‘ferrea’ / ‘ferreus’ meaning ‘relating to iron’
ferruginea|From the Latin ‘ferruginea’ / ‘ferrugineus’ meaning ‘relating to iron’
ferulaceum|From the Latin ‘ferulaceum’ / ‘ferulaceus’ meaning ‘resembling fennel’
ferulifolia|From the Latin ‘feruli’ / ‘ferula’ meaning ‘fennel’; and the Latin ‘folia’ / ‘folium’ meaning ‘leaf’.
ficoidea|From the Latin ‘fic’ / ‘ficus’ meaning ‘fig’; and the Greek ‘oidea’ / ‘oides’ meaning ‘in the form of’.
filacea|From the Latin ‘filacea’ / ‘filaceus’ meaning ‘thread-like’
filicaulis|From the Latin ‘fili’ / ‘filum’ meaning ‘thread’; and the Latin ‘caulis’ / ‘caulis’ meaning ‘stalk’.
filicornis|From the Latin ‘fili’ / ‘filum’ meaning ‘thread’; and the Latin ‘cornis’ / ‘cornus’ meaning ‘horn’.
filifolia|From the Latin ‘fili’ / ‘filum’ meaning ‘thread’; and the Latin ‘folia’ / ‘folium’ meaning ‘leaf’.
filiforme|From the Latin ‘fili’ / ‘filum’ meaning ‘thread’; and the Latin ‘forme’ / ‘formis’ meaning ‘in the form of’.
filiformis|From the Latin ‘fili’ / ‘filum’ meaning ‘thread’; and the Latin ‘formis’ / ‘formis’ meaning ‘in the form of’.
fimbriifolius|From the Latin ‘fimbrii’ / ‘fimbriae’ meaning ‘fringe’; and the Latin ‘folius’ / ‘folium’ meaning ‘leaf’.
fimbriolata|From the Latin ‘fimbriolata’ / ‘fimbriolatus’ meaning ‘equipped with a fringe’
fistulosa|From the Latin ‘fistulosa’ / ‘fistulosus’ meaning ‘equipped with narrow pipes’
flaccida|From the Latin ‘flaccida’ / ‘flaccidus’ meaning ‘flaccid’
flava|From the Latin ‘flava’ / ‘flavus’ meaning ‘yellow’
flexifolia|From the Latin ‘flexi’ / ‘flexus’ meaning ‘bending’; and the Latin ‘folia’ / ‘folium’ meaning ‘leaf’.
flexum|From the Latin ‘flexum’ / ‘fleus’ meaning ‘bent’
flexuosa|From the Latin ‘flexuosa’ / ‘flexuosus’ meaning ‘tortuous’
flexuosum|From the Latin ‘flexuosum’ / ‘flexuosus’ meaning ‘tortuous’
floribunda|From the Latin ‘flori’ / ‘flos’ meaning ‘flower’; and the Latin ‘bunda’ / ‘abundus’ meaning ‘copious’.
floribundum|From the Latin ‘flori’ / ‘flos’ meaning ‘flower’; and the Latin ‘bundum’ / ‘abundus’ meaning ‘copious’.
floridum|From the Latin ‘floridum’ / ‘floridus’ meaning ‘flowery’
foeniculoides|From the Latin ‘foenicul’ / ‘foeniculum’ meaning ‘fennel’; and the Greek ‘oides’ / ‘oides’ meaning ‘in the form of’.
foetida|From the Latin ‘foetida’ / ‘foetidus’ meaning ‘foetid’
foetidum|From the Latin ‘foetidum’ / ‘foetidus’ meaning ‘foetid’
foliosa|From the Latin ‘foliosa’ / ‘foliosus’ meaning ‘leafy’
foliosum|From the Latin ‘foliosum’ / ‘foliosus’ meaning ‘leafy’
fontana|From the Latin ‘fontana’ / ‘fontanus’ meaning ‘resembling a fountain’
forbesiana|From the English ‘forbesiana’ / ‘Forbes’ meaning ‘commemorating a botanist of this name’
forbesii|From the English ‘forbesii’ / ‘Forbes’ meaning ‘commemorating a botanist of this name’
forficaria|From the Latin ‘forficaria’ / ‘forficarius’ meaning ‘relating to a pair of shears’
forficata|From the Latin ‘forficata’ / ‘forficatus’ meaning ‘resembling a pair of shears’
fourcadei|From the French ‘fourcadei’ / ‘Fourcade’ meaning ‘commemorating botanist Henry Fourcade (1865-1948), surveyor and collector in the Southern Cape.’
foveolatus|From the Latin ‘foveolatus’ / ‘foveolatus’ meaning ‘marked with depressions’
fragile|From the Latin ‘fragile’ / ‘fragilis’ meaning ‘fragile’
fragrans|From the Latin ‘fragrans’ / ‘fragrans’ meaning ‘fragrant’
frangula|From the Latin ‘frangula???’ / ‘frangulus???’ meaning ‘somewhat broken’
fraternus|From the Latin ‘fraternus’ / ‘fraternus’ meaning ‘brotherly’
frisea|From the Dutch ‘frisea’ / ‘friseus’ meaning ‘relating to Friesland’
frutescens|From the Latin ‘frutescens’ / ‘frutenscens’ meaning ‘producing shoots’
fruticans|From the Latin ‘fruticans’ / ‘fruticans’ meaning ‘producing shoots’
fruticosa|From the Latin ‘fruticosa’ / ‘fruticosus’ meaning ‘bushy’
fruticosum|From the Latin ‘fruticosum’ / ‘fruticosus’ meaning ‘bushy’
fruticosus|From the Latin ‘fruticosus’ / ‘fruticosus’ meaning ‘bushy’
fruticulosum|From the Latin ‘fruticulosum’ / ‘fruticulosus’ meaning ‘somewhat bushy’
fruticulosus|From the Latin ‘fruticulosus’ / ‘fruticulosus’ meaning ‘somewhat bushy’
fucatus|From the Latin ‘fucatus’ / ‘fucatus’ meaning ‘painted’
fugacissima|From the Latin ‘fugacissima’ / ‘fugacissimus’ meaning ‘very fleeting’
fugax|From the Latin ‘fugax’ / ‘fugax’ meaning ‘fleeting’
fulvum|From the Latin ‘fulvum’ / ‘fulvus’ meaning ‘tawny or yellow’
funale|From the Latin ‘funale’ / ‘funalis’ meaning ‘thread-like’
furvus|From the Latin ‘furvus’ / ‘furvus’ meaning ‘dark’
fusca|From the Latin ‘fusca’ / ‘fuscus’ meaning ‘dark’
galaxia|From the Greek ‘galaxia’ / ‘galaxos’ meaning ‘the Milky Way’
galbaniopse|From the Latin ‘galbani’ / ‘galbanum’ meaning ‘an umbelliferous plant’; and the Greek ‘opse’ / ‘opsis’ meaning ‘face’.
galbanum|From the Latin ‘galbanum’ / ‘galbanum’ meaning ‘resinous sap of an umbelliferous plant’
galioides|From the Latin ‘gali’ / ‘galium’ meaning ‘bed-straw’; and the Greek ‘oides’ / ‘oides’ meaning ‘in the form of’.
gallica|From the Latin ‘gallica’ / ‘gallicus’ meaning ‘pertaining to France’
garcinii|From the Swiss ‘garcinii’ / ‘Garcin’ meaning ‘commemorating the Swiss botanist Laurent Garcin (1683-1751)’
gaudichaudiana|From the French ‘gaudichaudiana’ / ‘Gaudichand’ meaning ‘commemorating French botanist A. Gaudichand’
gawleri|From the English ‘gawleri’ / ‘Gawler’ meaning ‘commemorating a botanist of this name’
gayana|From the English ‘gayana’ / ‘Gay’ meaning ‘commemorating a botanist of this name’
geifolia|From the Latin ‘gei’ / ‘geum’ meaning ‘the herb called bennet’; and the Latin ‘flora’ / ‘flos’ meaning ‘flower’.
geminiflora|From the Latin ‘gemini’ / ‘geminus’ meaning ‘twin’; and the Latin ‘flora’ / ‘flos’ meaning ‘flower’.
geniculata|From the Latin ‘geniculata’ / ‘geniculatus’ meaning ‘equipped with little knees’
genistifolia|From the Latin ‘genisti’ / ‘genista’ meaning ‘the plant called broom’; and the Latin ‘folia’ / ‘folium’ meaning ‘leaf’.
genistoides|From the Latin ‘genist’ / ‘genista’ meaning ‘the plant called broom’; and the Greek ‘oides’ / ‘oides’ meaning ‘in the form of’.
gibba|From the Latin ‘gibba’ / ‘gibbus’ meaning ‘hunched’
gibbosa|From the Latin ‘gibbosa’ / ‘gibbosus’ meaning ‘humped’
gibbosum|From the Latin ‘gibbosum’ / ‘gibbosus’ meaning ‘humped’
giganteum|From the Latin ‘giganteum’ / ‘giganteus’ meaning ‘huge’
gilva|From the Latin ‘gilva’ / ‘gilvus’ meaning ‘yellow’
glabella|From the Latin ‘glabella’ / ‘glabellus’ meaning ‘somewhat smooth’
glaber|From the Latin ‘glaber’ / ‘glaber’ meaning ‘smooth’
glabra|From the Latin ‘glabra’ / ‘glaber’ meaning ‘smooth’
glabrata|From the Latin ‘glabrata’ / ‘glabratus’ meaning ‘rendered smooth’
glabripes|From the Latin ‘glabri’ / ‘glaber’ meaning ‘smooth’; and the Latin ‘pes’ / ‘pes’ meaning ‘foot’.
glabrum|From the Latin ‘glabrum’ / ‘glaber’ meaning ‘smooth’
gladiata|From the Latin ‘gladiata’ / ‘gladiatus’ meaning ‘sword-like’
glandulosa|From the Latin ‘glandulosa’ / ‘glandulosus’ meaning ‘equipped with glands’
glauca|From the Latin ‘glauca’ / ‘glaucus’ meaning ‘greenish-grey’
glaucophyllus|From the Latin ‘glauco’ / ‘glaucus’ meaning ‘greenish-grey’; and the Greek ‘phyllus’ / ‘phyllon’ meaning ‘leaf’.
glaucus|From the Latin ‘glaucus’ / ‘glaucus’ meaning ‘greenish-grey’
globosa|From the Latin ‘globosa’ / ‘globosus’ meaning ‘globe-shaped’
globulosa|From the Latin ‘globulosa’ / ‘globulosus’ meaning ‘equipped with globules’
glomerata|From the Latin ‘glomerata’ / ‘glomeratus’ meaning ‘thickly clustered’
glomeratum|From the Latin ‘glomeratum’ / ‘glomeratus’ meaning ‘thickly clustered’
glomeratus|From the Latin ‘glomeratus’ / ‘glomeratus’ meaning ‘thickly clustered’
glutinarius|From the Latin ‘glutinarius’ / ‘glutinarius’ meaning ‘gluey’
glutinosa|From the Latin ‘glutinosa’ / ‘glutinosus’ meaning ‘gluey’
gnaphaloides|From the Greek ‘gnaphal’ / ‘gnaphalon’ meaning ‘hank of wool’; and the Greek ‘oides’ / ‘oides’ meaning ‘in the form of’.
goodiana|From the English ‘goodiana’ / ‘Good’ meaning ‘commemorating a botanist of this name’
gracile|From the Latin ‘gracile’ / ‘gracilis’ meaning ‘graceful’
gracilis|From the Latin ‘gracilis’ / ‘gracilis’ meaning ‘graceful’
gracillima|From the Latin ‘gracillima’ / ‘gracillimus’ meaning ‘very graceful’
graminea|From the Latin ‘graminea’ / ‘gramineus’ meaning ‘grassy’
graminifolia|From the Latin ‘gramini’ / ‘gramen’ meaning ‘grass’; and the Latin ‘folia’ / ‘folium’ meaning ‘leaf’.
graminifolium|From the Latin ‘gramini’ / ‘gramen’ meaning ‘grass’; and the Latin ‘folium’ / ‘folium’ meaning ‘leaf’.
grandiceps|From the Latin ‘grandi’ / ‘grandis’ meaning ‘large’; and the Latin ‘ceps’ / ‘caput’ meaning ‘head’.
grandiflora|From the Latin ‘grandi’ / ‘grandis’ meaning ‘large’; and the Latin ‘flora’ / ‘flos’ meaning ‘flower’.
grandiflorum|From the Latin ‘grandi’ / ‘grandis’ meaning ‘large’; and the Latin ‘’ / ‘flos’ meaning ‘flower’.
grandiflorus|From the Latin ‘grandi’ / ‘grandis’ meaning ‘large’; and the Latin ‘florus’ / ‘flos’ meaning ‘flower’.
grossularifolia|From the Latin ‘grossulari’ / ‘grossulus’ meaning ‘a small unripe fig’; and the Latin ‘folia’ / ‘folium’ meaning ‘leaf’.
grossularoides|From the Latin ‘grossular’ / ‘grossulus’ meaning ‘a small unripe fig’; and the Greek ‘oides’ / ‘oides’ meaning ‘in the form of’.
guineense|From the Latin ‘guineense’ / ‘guineensis’ meaning ‘relating to Guinea’
guthriae|From the English ‘guthriae’ / ‘Guthrie’ meaning ‘commemorating a botanist of this name’
guttata|From the Latin ‘guttata’ / ‘guttatus’ meaning ‘spotted’
haematocodon|From the Greek ‘haemato’ / ‘haimatos’ meaning ‘resembling blood’; and the Latin ‘codon’ / ‘kodon’ meaning ‘bell’.
halicababa|
halimifolius|From the Greek ‘halimi’ / ‘halimon’ meaning ‘resembling the plant called orach’; and the Latin ‘folius’ / ‘folium’ meaning ‘leaf’.
hallackii|From the English ‘hallackii’ / ‘Hallack’ meaning ‘commemorating a botanist of this name’
harveyana|From the English ‘harveyana’ / ‘Harvey’ meaning ‘commemorating a botanist of this name’
harveyi|From the English ‘harveyi’ / ‘Harvey’ meaning ‘commemorating a botanist of this name’
hastata|From the Latin ‘hastata’ / ‘hastatus’ meaning ‘spear-like’
hastatus|From the Latin ‘hastatus’ / ‘hastatus’ meaning ‘spear-like’
hastifolius|From the Latin ‘hasti’ / ‘hasta’ meaning ‘spear’; and the Latin ‘folius’ / ‘folium’ meaning ‘leaf’.
heisteria|From the German ‘heisteria’ / ‘Heister’ meaning ‘commemorating a botanist of this name’
heleogena|From the Greek ‘heleo’ / ‘eleios’ meaning ‘relating to a marsh’; and the Greek ‘genus’ / ‘genos’ meaning ‘born’.
helianthemifolium|From the Greek ‘heli’ / ‘helios’ meaning ‘sun’; and the Greek ‘anthemum’ / ‘anthemon’ meaning ‘flower’.
hemisphaericus|From the Greek ‘hemisphaericus’ / ‘hemisphaerikos’ meaning ‘hemispherical’
herbacea|From the Latin ‘herbacea’ / ‘herbaceus’ meaning ‘grassy’
herniariifolia|From the Latin ‘herniarii’ / ‘herniaius’ meaning ‘plant supposed to cure hernias’; and the Latin ‘folia’ / ‘folium’ meaning ‘leaf’.
herrei|From the German ‘herrei’ / ‘Herr’ meaning ‘commemorating a botanist of this name’
heterophylla|From the Greek ‘hetero’ / ‘heteros’ meaning ‘the other of the two’; and the Greek ‘phylla’ / ‘phyllon’ meaning ‘leaf’.
heterophyllum|From the Greek ‘hetero’ / ‘heteros’ meaning ‘the other of the two’; and the Greek ‘phyllon’ / ‘phyllon’ meaning ‘leaf’.
hexandra|From the Greek ‘hex’ / ‘hex’ meaning ‘six’; and the Greek ‘andra’ / ‘andros’ meaning ‘anther’.
hians|From the Latin ‘hians’ / ‘hians’ meaning ‘hanging open’
hiemalis|From the Latin ‘hiemalis’ / ‘hiemalis’ meaning ‘relating to the  winter’
hilaris|From the Latin ‘hilaris’ / ‘hilaris’ meaning ‘cheerful’
hirsuta|From the Latin ‘hirsuta’ / ‘hirsutus’ meaning ‘hairy’
hirsutiflora|From the Latin ‘hirsuti’ / ‘hirsutus’ meaning ‘hairy’; and the Latin ‘flora’ / ‘flos’ meaning ‘flower’.
hirsutum|From the Latin ‘hirsutum’ / ‘hirsutus’ meaning ‘hairy’
hirsutus|From the Latin ‘hirsutus’ / ‘hirsutus’ meaning ‘hairy’
hirta|From the Latin ‘hirta’ / ‘hirtus’ meaning ‘hairy’
hirtiflora|From the Latin ‘hirti’ / ‘hirtus’ meaning ‘hairy’; and the Latin ‘flora’ / ‘flos’ meaning ‘flower’.
hirtulum|From the Latin ‘hirtulum’ / ‘hirtulus’ meaning ‘somewhat hairy’
hirtum|From the Latin ‘hirtum’ / ‘hirtus’ meaning ‘hairy’
hirtus|From the Latin ‘hirtus’ / ‘hirtus’ meaning ‘hairy’
hispida|From the Latin ‘hispida’ / ‘hispidus’ meaning ‘hairy’
hispidula|From the Latin ‘hispidula’ / ‘hispidulus’ meaning ‘somewhat hairy’
hispidulum|From the Latin ‘hispidulum’ / ‘hispidulus’ meaning ‘somewhat hairy’
hispidum|From the Latin ‘hispidum’ / ‘hispidus’ meaning ‘hairy’
hookeri|From the English ‘hookeri’ / ‘Hooker’ meaning ‘commemorating a botanist of this name’
hordaeceus|From the Latin ‘hordaceus’ / ‘hordaceus’ meaning ‘resembling barley’
humifusa|From the Latin ‘humi’ / ‘humus’ meaning ‘ground’; and the Latin ‘fusa’ / ‘fusus’ meaning ‘poured over’.
humile|From the Latin ‘humile’ / ‘humilis’ meaning ‘humble’
humilis|From the Latin ‘humilis’ / ‘humilis’ meaning ‘humble’
hyacinthoides|From the Greek ‘hyacinth’ / ‘hyakinthos’ meaning ‘hyacinth’; and the Greek ‘oides’ / ‘oides’ meaning ‘in the form of’.
hyalinus|From the Latin ‘hyalinus’ / ‘hyalinus’ meaning ‘glassy’
hypophyllocarpodendron|From the Greek ‘hypo’ / ‘hypo’ meaning ‘under’; and the Greek ‘phyllo’ / ‘phyllon’ meaning ‘leaf’.
hyssopifolia|From the Latin ‘hyssopi’ / ‘hyssopus’ meaning ‘hyssop’; and the Latin ‘folia’ / ‘folium’ meaning ‘leaf’.
hyssopifolium|From the Latin ‘hyssopi’ / ‘hyssopus’ meaning ‘hyssop’; and the Latin ‘folium’ / ‘folium’ meaning ‘leaf’.
hystrix|From the Latin ‘hystrix’ / ‘hystrix’ meaning ‘porcupine’
ilicifolia|From the Latin ‘ilici’ / ‘ilex’ meaning ‘holly’; and the Latin ‘folia’ / ‘folium’ meaning ‘leaf’.
imberbis|From the Latin ‘imberbis’ / ‘imberbis’ meaning ‘beardless’
imbricata|From the Latin ‘imbricata’ / ‘imbricatus’ meaning ‘tiled’
imbricatum|From the Latin ‘imbricatum’ / ‘imbricatus’ meaning ‘tiled’
imbricatus|From the Latin ‘imbricatus’ / ‘imbricatus’ meaning ‘tiled’
impolita|From the Latin ‘impolita’ / ‘impolitus’ meaning ‘rough’
inaequalis|From the Latin ‘inaequalis’ / ‘inaequalis’ meaning ‘unequal’
incana|From the Latin ‘incana’ / ‘incanus’ meaning ‘hoary’
incanum|From the Latin ‘incanum’ / ‘incanus’ meaning ‘hoary’
incarnata|From the Latin ‘incarnata’ / ‘incarnatus’ meaning ‘resembling pink flesh’
incisa|From the Latin ‘incisa’ / ‘incisus’ meaning ‘bearing cuts’
incomptula|From the Latin ‘incomptula’ / ‘incomptulus’ meaning ‘somewhat undecorated’
inconspicua|From the Latin ‘inconspicua’ / ‘inconspicuus’ meaning ‘inconspicuous’
incurva|From the Latin ‘incurva’ / ‘incurvus’ meaning ‘straight’
incurvata|From the Latin ‘incurvata’ / ‘incurvatus’ meaning ‘straight’
indica|From the Latin ‘indica’ / ‘indicus’ meaning ‘relating to India’
indicum|From the Latin ‘indicum’ / ‘indicus’ meaning ‘relating to India’
inequalis|From the Latin ‘inequalis’ / ‘inequalis’ meaning ‘unequal’
inerme|From the Latin ‘inerme’ / ‘inermis’ meaning ‘unarmed’
iners|From the Latin ‘iners’ / ‘iners’ meaning ‘motionless’
inflata|From the Latin ‘inflata’ / ‘infflatus’ meaning ‘inflated’
inflexa|From the Latin ‘inflexa’ / ‘inflexus’ meaning ‘inflexible’
inflexum|From the Latin ‘inflexum’ / ‘inflexus’ meaning ‘inflexible’
integerrima|From the Latin ‘integerrima’ / ‘integerrimus’ meaning ‘wholly complete’
integrifolia|From the Latin ‘integri’ / ‘integer’ meaning ‘complete’; and the Latin ‘folia’ / ‘folium’ meaning ‘leaf’.
intermedia|From the Latin ‘intermedia’ / ‘intermedius’ meaning ‘intermediate’
inundatum|From the Latin ‘inundatum’ / ‘inundatus’ meaning ‘flooded’
inusta|From the Latin ‘inusta’ / ‘inustus’ meaning ‘scorched’
involucrata|From the Latin ‘involucrata’ / ‘involucratus’ meaning ‘with a whorl of bracts’
iocastum|From the Greek? ‘iocastum’ / ‘Jocasta?’ meaning ‘alluding to the mother of Oedipus?’
isoetifolia|From the Latin ‘isoei’ / ‘isoetes’ meaning ‘a genus of fern’; and the Latin ‘folia’ / ‘folium’ meaning ‘leaf’.
ixioides|From the Greek ‘ixi’ / ‘ixia’ meaning ‘a South African  flower Latin’; and the Greek ‘oides’ / ‘oides’ meaning ‘in the form of’.
jasminoides|From the Arabic ‘jasmini’ / ‘yasamin’ meaning ‘sweet-smelling creeper’; and the Greek ‘oides’ / ‘oides’ meaning ‘in the form of’.
jonquilliodorus|From the Spanish ‘jonquilli’ / ‘junquillo’ meaning ‘a kind of narcissus’; and the Latin ‘odorus’ / ‘odorus’ meaning ‘emitting a fragrance’.
juncea|From the Latin ‘juncea’ / ‘junceus’ meaning ‘resembling a reed’
junceus|From the Latin ‘junceus’ / ‘junceus’ meaning ‘resembling a reed’
juncifolia|From the Latin ‘junci’ / ‘juncus’ meaning ‘reed’; and the Latin ‘folia’ / ‘folium’ meaning ‘leaf’.
junciformis|From the Latin ‘junci’ / ‘juncus’ meaning ‘reed’; and the Latin ‘formis’ / ‘formis’ meaning ‘in the form of’.
juniperifolia|From the Latin ‘juniperi’ / ‘juniperus’ meaning ‘juniper tree’; and the Latin ‘folia’ / ‘folium’ meaning ‘leaf’.
juniperina|From the Latin ‘juniper’ / ‘juniperus’ meaning ‘juniper tree’; and the Latin ‘ina’ / ‘inus’ meaning ‘adjectival suffix’.
kali|From the Hindu???? ‘kali’ / ‘Hindu goddess of vengeance????’ meaning ‘’
karroo|From the Nama ‘karroo’ / ‘karroo’ meaning ‘an arid area of South Africa’
kraussiana|From the German ‘kraussiana’ / ‘Krauss’ meaning ‘commemorating a botanist of this name’
kraussianus|From the German ‘kraussianus’ / ‘Krauss’ meaning ‘commemorating a botanist of this name’
kraussii|From the German ‘kraussii’ / ‘Krauss’ meaning ‘commemorating a botanist of this name’
krebsiana|From the German ‘krebsiana’ / ‘Krebs’ meaning ‘commemorating a botanist of this name’
labialis|From the Latin ‘labialis’ / ‘labialis’ meaning ‘relating to the lips’
lacera|From the Latin ‘lacera’ / ‘lacerare’ meaning ‘to lacerate’
lachnantha|From the Greek ‘lachnantha’ / ‘lachne’ meaning ‘wool’; and the Greek ‘antha’ / ‘anthos’ meaning ‘flower’.
laeta|From the Latin ‘laeta’ / ‘laetus’ meaning ‘joyful’
laeve|From the Latin ‘laeve’ / ‘laevis’ meaning ‘light’
laevigata|From the Latin ‘laevigata’ / ‘laevigatus’ meaning ‘smoothed’
laevigatum|From the Latin ‘laevigatum’ / ‘laevigatus’ meaning ‘smoothed’
laevigatus|From the Latin ‘laevigatus’ / ‘laevigatus’ meaning ‘smoothed’
lagopus|; and the Greek ‘pus’ / ‘pous’ meaning ‘foot’.
lalandii|
lamellata|From the Latin ‘lamellata’ / ‘lamellatus’ meaning ‘equipped with small plates’
lanata|From the Latin ‘lanata’ / ‘lanatus’ meaning ‘furnished with wool’
lanatum|From the Latin ‘lanatum’ / ‘lanatus’ meaning ‘furnished with wool’
lanatus|From the Latin ‘lanatus’ / ‘lanatus’ meaning ‘furnished with wool’
lanceolata|From the Latin ‘lanceolata’ / ‘lanceolatus’ meaning ‘equipped with small lances’
lanceum|From the Latin ‘lanceum’ / ‘lanceus’ meaning ‘lance-like’
lanceus|From the Latin ‘lanceus’ / ‘lanceus’ meaning ‘lance-like’
lancifolium|From the Latin ‘lanci’ / ‘lancea’ meaning ‘lance’; and the Latin ‘folia’ / ‘folium’ meaning ‘leaf’.
lanifer|From the Latin ‘lani’ / ‘lana’ meaning ‘wool’; and the Latin ‘fer’ / ‘ferus’ meaning ‘bearing’.
lanuginosa|From the Latin ‘lanuginosa’ / ‘lanuginosus’ meaning ‘woolly’
laricifolia|From the Latin ‘larici’ / ‘larix’ meaning ‘larch’; and the Latin ‘folia’ / ‘folium’ meaning ‘leaf’.
lasciva|From the Latin ‘lasciva’ / ‘lascivus’ meaning ‘lascivious’
lateralis|From the Latin ‘lateralis’ / ‘lateralis’ meaning ‘relating to the side’
latifolia|From the Latin ‘lati’ / ‘latus’ meaning ‘side’; and the Latin ‘folia’ / ‘folium’ meaning ‘leaf’.
latifolius|From the Latin ‘lati’ / ‘latus’ meaning ‘side’; and the Latin ‘folius’ / ‘folium’ meaning ‘leaf’.
lativalvis|From the Latin ‘lati’ / ‘latus’ meaning ‘side’; and the Latin ‘valvis’ / ‘valva’ meaning ‘the leaf of a door’.
laureoleum|From the Latin ‘laureoleum’ / ‘laureolus’ meaning ‘relating to the laurel’
laxa|From the Latin ‘laxa’ / ‘laxus’ meaning ‘loose’
laxiflorus|From the Latin ‘laxi’ / ‘laxus’ meaning ‘loose’
laxifolia|From the Latin ‘laxi’ / ‘laxus’ meaning ‘loose’
lehmanniana|From the German ‘lehmanniana’ / ‘Lehmann’ meaning ‘commemorating a botanist of this name’
lehmannii|From the German ‘lehmannii’ / ‘Lehmann’ meaning ‘commemorating a botanist of this name’
leoninum|From the Latin ‘leoninum’ / ‘leoninus’ meaning ‘lion-like’
leonorus|From the Latin ‘leonorus’ / ‘leonorus’ meaning ‘lion-coloured’
lepidocarpodendron|From the Greek ‘lepido’ / ‘lepis’ meaning ‘scale’; and the Greek ‘carpo’ / ‘karpos’ meaning ‘fruit’.
lepta|From the Greek ‘lepta’ / ‘leptos’ meaning ‘delicate’
leptoclados|From the Greek ‘lepto’ / ‘leptos’ meaning ‘delicate’; and the Greek ‘clados’ / ‘klados’ meaning ‘twig’.
leptoloba|From the Greek ‘lepto’ / ‘leptos’ meaning ‘delicate’; and the Greek ‘loba’ / ‘lobos’ meaning ‘pod’.
leptophylla|From the Greek ‘lepto’ / ‘leptos’ meaning ‘delicate’; and the Greek ‘phylla’ / ‘phyllon’ meaning ‘leaf’.
leptostachyus|From the Greek ‘lepto’ / ‘leptos’ meaning ‘delicate’; and the Greek ‘stachys’ / ‘stachys’ meaning ‘spike’.
leucoloma|From the Greek ‘leuco’ / ‘leukos’ meaning ‘white’; and the Greek ‘loma’ / ‘lomentos’ meaning ‘breaking up when mature’.
levisanus|From the Hebrew???? ‘levisanus’ / ‘Levy????’ meaning ‘commemorating a botanist of this name ???’
levynsiae|From the Hebrew ‘levynsiae’ / ‘Levyns’ meaning ‘commemorating the botanist of this name’
lewisiae|From the English ‘lewisiae’ / ‘Lewis’ meaning ‘commemorating the botanist of this name’
lichtensteiniana|From the German ‘lichstensteiniana’ / ‘Lichtenstein’ meaning ‘commemorating the botanist of this name’
lignosus|From the Latin ‘lignosus’ / ‘lignosus’ meaning ‘woody’
ligulatum|From the Latin ‘ligulatum’ / ‘ligulatus’ meaning ‘equipped with shoe straps’
liliaceus|From the Latin ‘liliaceus’ / ‘liliaceus’ meaning ‘resembling a lily’
limosa|From the Latin ‘limosa’ / ‘limosus’ meaning ‘slimy or muddy’
lineare|From the Latin ‘lineare’ / ‘linearis’ meaning ‘relating to lines’
linearis|From the Latin ‘linearis’ / ‘linearis’ meaning ‘rellating to lines’
lineata|From the Latin ‘lineata’ / ‘lineatus’ meaning ‘striped’
lineatus|From the Latin ‘lineatus’ / ‘lineatus’ meaning ‘striped’
linguiloba|From the Latin ‘lingui’ / ‘linguis’ meaning ‘tongue’; and the Latin ‘loba’ / ‘lobus’ meaning ‘lobe’.
linnaei|From the Latin ‘linnaei’ / ‘Linnaeus’ meaning ‘commemorating the botanist of this name’
linoides|From the Greek ‘lin’ / ‘linon’ meaning ‘flax’; and the Greek ‘oides’ / ‘oides’ meaning ‘in the form of’.
litorale|From the Latin ‘litorale’ / ‘litorale’ meaning ‘relating to a bank or shore’
litoralis|From the Latin ‘litoralis’ / ‘litoralis’ meaning ‘relating to a bank or shore’
littorea|From the Latin ‘littorea’ / ‘littorea’ meaning ‘relating to a bank or shore’
littoreus|From the Latin ‘littoreus’ / ‘littoreus’ meaning ‘ relating to a bank or shore’
livida|From the Latin ‘livida’ / ‘lividus’ meaning ‘bluish’
lobatum|From the Latin ‘lobatum’ / ‘lobatus’ meaning ‘lobed’
longebracteata|From the Latin ‘longe’ / ‘longe’ meaning ‘at length’; and the Latin ‘bracteata’ / ‘bracteatus’ meaning ‘equipped with bracts’.
longicaule|From the Latin ‘longi’ / ‘longus’ meaning ‘long’; and the Latin ‘caule’ / ‘caulis’ meaning ‘stalk’.
longicornu|From the Latin ‘longi’ / ‘longus’ meaning ‘long’; and the Latin ‘cornu’ / ‘cornus’ meaning ‘horn’.
longiflora|From the Latin ‘longi’ / ‘longus’ meaning ‘long’; and the Latin ‘flora’ / ‘flos’ meaning ‘flower’.
longifolia|From the Latin ‘longi’ / ‘longus’ meaning ‘long’; and the Latin ‘folia’ / ‘folium’ meaning ‘leaf’.
longifolium|From the Latin ‘longi’ / ‘longus’ meaning ‘long’; and the Latin ‘folium’ / ‘folium’ meaning ‘leaf’.
longifolius|From the Latin ‘longi’ / ‘longus’ meaning ‘long’; and the Latin ‘folius’ / ‘folium’ meaning ‘leaf’.
longiglumis|From the Latin ‘longi’ / ‘longus’ meaning ‘long’; and the Latin ‘glumis’ / ‘gluma’ meaning ‘husk’.
longum|From the Latin ‘longi’ / ‘longus’ meaning ‘long’
longus|From the Latin ‘longi’ / ‘longus’ meaning ‘long’
lotoides|From the Greek ‘lot’ / ‘lotos’ meaning ‘the lotos tree’; and the Greek ‘oides’ / ‘oides’ meaning ‘in the form of’.
lucens|From the Latin ‘lucens’ / ‘lucens’ meaning ‘shining’
lucida|From the Latin ‘lucida’ / ‘lucidus’ meaning ‘bright’
ludwigii|From the German ‘ludwigii’ / ‘Ludwig’ meaning ‘Probably commemorating Friedrich Ludwig (1851-1918), a German botanist.’
lugens|From the Latin ‘lugens’ / ‘lugens’ meaning ‘mourning’
lugubris|From the Latin ‘lugubris’ / ‘lugubris’ meaning ‘mournful’
lunulatum|From the Latin ‘lunulatum’ / ‘lunulatus’ meaning ‘crescent-shaped’
lupulinum|From the Latin ‘lupulinum’ / ‘lupulinus’ meaning ‘resembling hops’
lurida|From the Latin ‘lurida’ / ‘pale yellow’ meaning ‘’
lutea|From the Latin ‘lutea’ / ‘golden  yellow’ meaning ‘’
luteola|From the Latin ‘luteola’ / ‘yellowish’ meaning ‘’
luxurians|From the Latin ‘;uxurians’ / ‘luxurians’ meaning ‘luxuriant’
lychnidea|From the Greek ‘lychn’ / ‘lychnos’ meaning ‘a red-flowered plant’; and the Latin ‘idea’ / ‘ideus’ meaning ‘adjectival suffix’.
lycopodioides|From the Greek ‘lyco’ / ‘lykos’ meaning ‘wolf’; and the Greek ‘podi’ / ‘pous’ meaning ‘foot’.
lyratus|From the Latin ‘lyratus’ / ‘lyratus’ meaning ‘resembling a lyre’
macowanii|From the Gaelic ‘macowanii’ / ‘Macowan’ meaning ‘commemorating a botanist of this name’
macrantha|From the Greek ‘macr’ / ‘makros’ meaning ‘big’; and the Greek ‘antha’ / ‘anthos’ meaning ‘flower’.
macrocalycina|From the Greek ‘macro’ / ‘makros’ meaning ‘big’; and the Greek ‘calcyina’ / ‘kalkynos’ meaning ‘relating to the calyx’.
macrocalyx|From the Greek ‘macro’ / ‘makros’ meaning ‘big’; and the Greek ‘calyx’ / ‘kalyx’ meaning ‘the petal clasp’.
macrocarpa|From the Greek ‘macro’ / ‘makros’ meaning ‘big’; and the Greek ‘carpa’ / ‘karpos’ meaning ‘fruit’.
macrodus|From the Greek ‘macr’ / ‘makros’ meaning ‘big’; and the Greek ‘odus’ / ‘odos????’ meaning ‘pathway????’.
macropetala|From the Greek ‘macro’ / ‘makros’ meaning ‘big’; and the Greek ‘petala’ / ‘petalon’ meaning ‘petal’.
macrourum|From the Gaelic???? ‘macrourum’ / ‘Macrory????’ meaning ‘commemorating a botanist of this name’
maculata|From the Latin ‘maculata’ / ‘maculatus’ meaning ‘stained’
maculatus|From the Latin ‘maculatus’ / ‘maculatus’ meaning ‘stained’
major|From the Latin ‘major’ / ‘major’ meaning ‘bigger’
malouinensis|From the ????? ‘malouinensis’ / ‘Mali?????’ meaning ‘deriving from Mali????’
mammosa|From the Latin ‘mammosa’ / ‘mammosus’ meaning ‘equipped with breasts’
margaritacea|From the Latin ‘margaritacea’ / ‘margaritaceus’ meaning ‘pearl-like or daisy-like’
marginata|From the Latin ‘marginata’ / ‘marginatus’ meaning ‘with a defined edge’
marginatus|From the Latin ‘marginatus’ / ‘marginatus’ meaning ‘with a defined edge’
marifolia|From the Latin ‘mari’ / ‘mare’ meaning ‘sea’; and the Latin ‘folia’ / ‘folium’ meaning ‘leaf’.
mariscus|From the Latin ‘mariscus’ / ‘mariscus’ meaning ‘rush’
maritima|From the Latin ‘maritima’ / ‘maritimus’ meaning ‘maritime’
maritimum|From the Latin ‘maritumum’ / ‘maritimus’ meaning ‘maritime’
maritimus|From the Latin ‘maritimus’ / ‘martimus’ meaning ‘maritime’
martleyi|From the English ‘martleyi’ / ‘Martley’ meaning ‘commemorating a botanist of this name’
maura|From the Latin ‘maura’ / ‘maurus’ meaning ‘relating to the Moors’
mauritanica|From the Latin ‘mauritanica’ / ‘Mauritania’ meaning ‘relating to Mauritania’
mauritianum|From the Latin ‘mauritianum’ / ‘Mauritania’ meaning ‘relating to Mauritania’
maxima|From the Latin ‘maxima’ / ‘maximus’ meaning ‘biggest’
maximum|From the Latin ‘maximum’ / ‘maximus’ meaning ‘biggest’
mearnsii|From the English ‘mearnsii’ / ‘Mearns’ meaning ‘commemorating a botanist of this name’
media|From the Latin ‘media’ / ‘medius’ meaning ‘in between’
mediana|From the Latin ‘mediana’ / ‘medianus’ meaning ‘relating to the  norm’
melanophloeos|From the Greek ‘melano’ / ‘melanos’ meaning ‘black’; and the Greek ‘pholoeos’ / ‘phloeos’ meaning ‘bark’.
melanoxylon|From the Greek ‘melano’ / ‘melanos’ meaning ‘black’; and the Greek ‘xylon’ / ‘xylon’ meaning ‘wood’.
melicoides|From the Italian ‘melic’ / ‘melica’ meaning ‘sorghum’; and the Greek ‘oides’ / ‘oides’ meaning ‘in the form of’.
meliusculus|From the Latin ‘meliusculus’ / ‘meliusculus’ meaning ‘somewhat better’
membranacea|From the Latin ‘membranacea’ / ‘membranaceus’ meaning ‘resembling a  membrane’
meriana|From the Dutch ‘meriana’ / ‘Merian’ meaning ‘commemorating a Dutch floral artist’
meridionalis|From the Latin ‘meridionalis’ / ‘meridionalis’ meaning ‘relating to the afternoon’
meyeri|From the German ‘meyeri’ / ‘Meyer’ meaning ‘commemorating a botanist of this name’
meyeriana|From the German ‘meyeriana’ / ‘Meyer’ meaning ‘commemorating a botanist of this name’
micans|From the Latin ‘micans’ / ‘micans’ meaning ‘glittering’
micrantha|From the Greek ‘mic’ / ‘mikros’ meaning ‘small’; and the Greek ‘antha’ / ‘anthos’ meaning ‘flower’.
microcarpum|From the Greek ‘micro’ / ‘mikros’ meaning ‘small’; and the Greek ‘carpum’ / ‘karpos’ meaning ‘fruit’.
microglossum|From the Greek ‘micro’ / ‘mikros’ meaning ‘small’; and the Greek ‘glossum’ / ‘glossa’ meaning ‘tongue’.
micropetala|From the Greek ‘micro’ / ‘mikros’ meaning ‘small’; and the Greek ‘petalum’ / ‘petalon’ meaning ‘petal’.
microphylla|From the Greek ‘micro’ / ‘mikros’ meaning ‘small’; and the Greek ‘phylla’ / ‘phyllon’ meaning ‘leaf’.
microstachys|From the Greek ‘micro’ / ‘mikros’ meaning ‘small’; and the Greek ‘stachys’ / ‘stachys’ meaning ‘spike’.
miniata|From the Latin ‘miniata’ / ‘miniatus’ meaning ‘red’
miniata|From the DUPLICATE ‘’ / ‘’ meaning ‘’
minor|From the Latin ‘minor’ / ‘minor’ meaning ‘smaller’
minuta|From the Latin ‘minuta’ / ‘minutus’ meaning ‘minute’
minutiflora|From the Latin ‘minuti’ / ‘mintus’ meaning ‘minute’; and the Latin ‘flora’ / ‘flos’ meaning ‘flower’.
mitior|From the Latin ‘mitior’ / ‘mitior’ meaning ‘milder’
mitis|From the Latin ‘mitis’ / ‘mitis’ meaning ‘mild’
mixta|From the Latin ‘mixta’ / ‘mixtus’ meaning ‘mixed’
moeserianum|From the German???? ‘moeserianum’ / ‘Moeser???’ meaning ‘commemorating a botanist of this name’
mollis|From the Latin ‘mollis’ / ‘gentle’ meaning ‘’
mollugo|From the Latin ‘mollugo’ / ‘mollugo’ meaning ‘a Roman name for a certain plant’
monadelpha|From the Greek ‘mon’ / ‘mono’ meaning ‘one’; and the Greek ‘adelpha’ / ‘adelphos’ meaning ‘brother’.
monanthes|From the Greek ‘mon’ / ‘mono’ meaning ‘one’
monilifera|From the Greek ‘mon’ / ‘mono’ meaning ‘one’
monopetala|From the Greek ‘mono’ / ‘mono’ meaning ‘one’
monophylla|From the Greek ‘mono’ / ‘mono’ meaning ‘one’
monspeliensis|From the Latin ‘mons’ / ‘mons’ meaning ‘mountain’; and the Latin ‘peliensis’ / ‘peliensis’ meaning ‘relating to the mountain Pelion’.
montanus|From the Latin ‘montanus’ / ‘montanus’ meaning ‘relating to mountains’
monticola|From the Latin ‘monticola’ / ‘monticola’ meaning ‘a mountain-dweller’
morgsana|
mucronata|From the Latin ‘mucronata’ / ‘mucronatus’ meaning ‘pointed’
mucronatum|From the Latin ‘mucronatum’ / ‘mucronatus’ meaning ‘pointed’
muirii|From the Gaelic ‘muirii’ / ‘Muir’ meaning ‘commemorating a botanist of this name’
multicaulis|From the Latin ‘multi’ / ‘multi’ meaning ‘many’; and the Latin ‘caulis’ / ‘caulis’ meaning ‘stalk’.
multifidus|From the Latin ‘multi’ / ‘multi’ meaning ‘many’; and the Latin ‘fidus’ / ‘fidus’ meaning ‘cleavage’.
multiflora|From the Latin ‘multi’ / ‘multi’ meaning ‘many’; and the Latin ‘flora’ / ‘flos’ meaning ‘flower’.
multiflorum|From the Latin ‘multi’ / ‘multi’ meaning ‘many’; and the Latin ‘florum’ / ‘flos’ meaning ‘flower’.
multiflorus|From the Latin ‘multi’ / ‘multi’ meaning ‘many’; and the Latin ‘florus’ / ‘flos’ meaning ‘flower’.
multiradiatum|From the Latin ‘multi’ / ‘multi’ meaning ‘many’; and the Latin ‘radiatum’ / ‘radiatus’ meaning ‘invested with rays’.
multiradiatus|From the Latin ‘multi’ / ‘multi’ meaning ‘many’; and the Latin ‘radiatus’ / ‘rardiatus’ meaning ‘invested with rays’.
multumbellifera|From the Latin ‘mult’ / ‘multi’ meaning ‘many’; and the Latin ‘umbelli’ / ‘umbellum’ meaning ‘umbrella’.
mundianum|From the German ‘mundianum’ / ‘Mundt’ meaning ‘commemorating a botanist of this name’
mundii|From the Latin ‘mundii’ / ‘Mundt’ meaning ‘commemorating a botanist of this name’
muralis|From the Latin ‘muralis’ / ‘muralis’ meaning ‘relating to walls’
muricata|From the Latin ‘muricata’ / ‘muricatus’ meaning ‘pointed’
muricatus|From the Latin ‘muricatus’ / ‘muricatus’ meaning ‘pointed’
murinum |From the Latin ‘murinum’ / ‘murinus’ meaning ‘mouse-like’
muscosa|From the Latin ‘muscosa’ / ‘muscosus’ meaning ‘mossy’
myriophylloides|From the Greek ‘myrio’ / ‘myrios’ meaning ‘countless’; and the Greek ‘phyll’ / ‘phyllon’ meaning ‘leaf’.
myrrhifolium|From the Greek ‘myrrhi’ / ‘myrrhis’ meaning ‘myrrh’; and the Latin ‘folium’ / ‘folium’ meaning ‘leaf’.
myrsinites|From the Greek ‘myrsin’ / ‘myrsine’ meaning ‘myrtle’; and the Greek ‘ites’ / ‘ites’ meaning ‘adjectival suffix’.
myrtifolia|From the Greek ‘myrt’ / ‘myrtos’ meaning ‘myrtle’; and the Latin ‘folia’ / ‘folium’ meaning ‘leaf’.
myrtina|From the Latin ‘myrtina’ / ‘myrtinus’ meaning ‘myrtle-like’
myuros|From the Greek ‘myuros’ / ‘mus’ meaning ‘mouse’; and the Greek ‘uros’ / ‘ouros’ meaning ‘tail’.
namaquensis|From the Nama ‘namaquensis’ / ‘nama gu a’ meaning ‘a dry region of South Africa’
nana|From the Latin ‘nana’ / ‘nanus’ meaning ‘dwarf’
nanodes|From the Latin ‘nan’ / ‘nanus’ meaning ‘dwarf’; and the Greek ‘odes’ / ‘oides’ meaning ‘in the form of’.
nanum|From the Latin ‘nanum’ / ‘nanus’ meaning ‘dwarf’
natalensis|From the Latin ‘natalensis’ / ‘Natal’ meaning ‘subtropical region of South Africa’
natans|From the Latin ‘natans’ / ‘natans’ meaning ‘swimming’
neesii|From the Dutch ‘neesii’ / ‘Nees’ meaning ‘commemorating Nees von Eysenbeck’
neglecta|From the Latin ‘neglecta’ / ‘neglectus’ meaning ‘neglected’
nematocaulis|From the Greek ‘nematocaulis’ / ‘nematos’ meaning ‘thread-like’; and the Latin ‘caulis’ / ‘caulis’ meaning ‘stalk’.
neriifolia|From the Greek ‘nerii’ / ‘nerion’ meaning ‘oleander’; and the Latin ‘folia’ / ‘folium’ meaning ‘leaf’.
nevillei|From the English ‘nevillei’ / ‘Neville’ meaning ‘commemorating a botanist of this name’
nidulans|From the Latin ‘nidulans’ / ‘nidulans’ meaning ‘nest-forming’
nigrescens|From the Latin ‘nigrescens’ / ‘nigrescens’ meaning ‘turning black’
nigricans|From the Latin ‘nigricans’ / ‘nigricans’ meaning ‘appearing blackish’
nigrita|From the Latin ‘nigrita’ / ‘nigritus’ meaning ‘blackened’
nigromontanum |From the Latin ‘nigro’ / ‘niger’ meaning ‘black’
nigrum|From the Latin ‘nigrum’ / ‘niger’ meaning ‘black’
nitida|From the Latin ‘nitida’ / ‘nitidus’ meaning ‘shiny’
nitidus|From the Latin ‘nitidus’ / ‘nitidus’ meaning ‘shiny’
nivea|From the Latin ‘nivea’ / ‘niveus’ meaning ‘snowy’
niveum|From the Latin ‘niveum’ / ‘niveus’ meaning ‘snowy’
nodiflora|From the Latin ‘nodi’ / ‘nodus’ meaning ‘knot’; and the Latin ‘flora’ / ‘flos’ meaning ‘flower’.
nodiflorum|From the Latin ‘nodi’ / ‘nodus’ meaning ‘knot’; and the Latin ‘florum’ / ‘flos’ meaning ‘flower’.
nodosus|From the Latin ‘nodosus’ / ‘nodosus’ meaning ‘knotty’
noduliflora|From the Latin ‘noduli’ / ‘nodulus’ meaning ‘somewhat knotty’; and the Latin ‘flora’ / ‘flos’ meaning ‘flower’.
nouchali|From the French? ‘nouchali’ / ‘Nouchal’ meaning ‘commemorating a botanist of this name?’
nuda|From the Latin ‘nuda’ / ‘nudus’ meaning ‘bare’
nudicaule|From the Latin ‘nudi’ / ‘nudus’ meaning ‘bare’
nudicaulis|From the Latin ‘nudi’ / ‘nudus’ meaning ‘bare’
nudiflora|From the Latin ‘nudi’ / ‘nudus’ meaning ‘bare’
nudifolium|From the Latin ‘nudi’ / ‘nudus’ meaning ‘bare’
nudum|From the Latin ‘nudum’ / ‘nudus’ meaning ‘bare’
nutans|From the Latin ‘nutans’ / ‘nutans’ meaning ‘nodding’
nycthemerum|From the Greek ‘nycthemerum’ / ‘nykthemeros’ meaning ‘lasting 24 hours’
obcordata|From the Latin ‘ob’ / ‘ob’ meaning ‘inversely’; and the Latin ‘cordata’ / ‘cordatus’ meaning ‘heart-shaped’.
oblanceolata|From the Latin ‘ob’ / ‘ob’ meaning ‘inversely’; and the Latin ‘lanceolata’ / ‘lanceolatus’ meaning ‘equipped with small lances’.
obliqua|From the Latin ‘obliqua’ / ‘obliquus’ meaning ‘oblique’
obliquum|From the Latin ‘obliquum’ / ‘obliquus’ meaning ‘oblique’
obliterum|From the Latin ‘obliterum’ / ‘obliterus’ meaning ‘forgotten or erased’
obovata|From the Latin ‘ob’ / ‘ob’ meaning ‘inversely’; and the Latin ‘ovata’ / ‘ovatus’ meaning ‘egg-shaped’.
obscura|From the Latin ‘obscura’ / ‘obscurus’ meaning ‘obscure’
obtusissimus|From the Latin ‘obtusisimus’ / ‘obtusisimus’ meaning ‘most blunt’
obtusa|From the Latin ‘obtusa’ / ‘obtusus’ meaning ‘blunt’
obtusata|From the Latin ‘obtusata’ / ‘obtusatus’ meaning ‘rendered blunt’
obtusifolium|From the Latin ‘obtusi’ / ‘obtusus’ meaning ‘blunt’; and the Latin ‘folium’ / ‘folium’ meaning ‘leaf’.
obtusus|From the Latin ‘obtusus’ / ‘obtusus’ meaning ‘blunt’
occidentale|From the Latin ‘occidentale’ / ‘occidentalis’ meaning ‘western’
occidentalis |From the Latin ‘occidentalis’ / ‘occidentalis’ meaning ‘western’
ocellata|From the Latin ‘ocellata’ / ‘ocellatus’ meaning ‘invested with small eyes’
ochroleuca|From the Greek ‘ochro’ / ‘ochros’ meaning ‘ochre’; and the Greek ‘leuca’ / ‘leukos’ meaning ‘white’.
ocreata|From the Latin ‘ocreata’ / ‘ocreatus’ meaning ‘rendered ochre’
odorata|From the Latin ‘odorata’ / ‘odoratus’ meaning ‘fragrant’
odoratissimum|From the Latin ‘odoratissimum’ / ‘odoratissimus’ meaning ‘most fragrant’
odorum|From the Latin ‘odorum’ / ‘odorus’ meaning ‘fragrant’
oleoides|From the Latin ‘ole’ / ‘olea’ meaning ‘olive’; and the Greek ‘oides’ / ‘oides’ meaning ‘in the form of’.
oligantha|From the Greek ‘olig’ / ‘oligoi’ meaning ‘few’; and the Greek ‘antha’ / ‘anthos’ meaning ‘flower’.
onobromoides|From the Greek ‘onobro’ / ‘onobrychis????’ meaning ‘the plant called palmes assini’; and the Greek ‘oides’ / ‘oides’ meaning ‘in the form of’.
ophrydea|From the Greek ‘ophrydea’ / ‘ophrydeos’ meaning ‘equipped with eyebrows’
oppositifolia|From the Latin ‘oppositi’ / ‘oppositus’ meaning ‘opposite’; and the Latin ‘folia’ / ‘folium’ meaning ‘leaf’.
orbicularis|From the Latin ‘orbicularis’ / ‘orbicularis’ meaning ‘orb-shaped’
orbiculata|From the Latin ‘orbiculata’ / ‘orbiculata’ meaning ‘made into an orb’
orchidiflorus|From the Latin ‘orchidi’ / ‘orchis’ meaning ‘orchid’; and the Latin ‘florus’ / ‘flos’ meaning ‘flower’.
orchioides|From the Latin ‘orchi’ / ‘orchis’ meaning ‘orchid’; and the Greek ‘oides’ / ‘oides’ meaning ‘in the form of’.
orientalis|From the Latin ‘orientalis’ / ‘orientalis’ meaning ‘eastern’
ornatus|From the Latin ‘ornatus’ / ‘ornatus’ meaning ‘ornate’
ornithopodon|From the Greek ‘ornitho’ / ‘ornithos’ meaning ‘bird’; and the Greek ‘podon’ / ‘podion’ meaning ‘small foot’.
orobanchoides|From the Greek ‘orobanch’ / ‘orobanche’ meaning ‘vetch’; and the Greek ‘oides’ / ‘oides’ meaning ‘in the form of’.
oroboides|From the Greek ‘orobo’ / ‘orobos’ meaning ‘vetch’; and the Greek ‘oides’ / ‘oides’ meaning ‘in the form of’.
ottonis|From the German ‘ottonis’ / ‘Otto’ meaning ‘commemorating a botanist of this name’
ovata|From the Latin ‘ovata’ / ‘ovatus’ meaning ‘egg-shaped’
ovatus|From the Latin ‘ovatus’ / ‘ovatus’ meaning ‘egg-shaped’
oxycoccifolia|From the Greek ‘oxy’ / ‘oxy’ meaning ‘sharp’; and the Greek ‘cocci’ / ‘kokkos’ meaning ‘berry’.
oxyptera|From the Greek ‘oxy’ / ‘oxy’ meaning ‘sharp’; and the Greek ‘ptera’ / ‘pteros’ meaning ‘wing’.
pageae|From the English ‘pageae’ / ‘Page’ meaning ‘commemorating a botanist of this name’
paleacea|From the Latin ‘paleacea’ / ‘paleaceus’ meaning ‘chaff-like’
pallens|From the Latin ‘pallens’ / ‘pallens’ meaning ‘pale’
pallescens|From the Latin ‘pallescens’ / ‘pallescens’ meaning ‘becoming  pale’
pallida|From the Latin ‘pallida’ / ‘pallidus’ meaning ‘pale’
paludicola|From the Latin ‘paludicola’ / ‘paludicola’ meaning ‘marsh-inhabitant’
paludosa|From the Latin ‘paludosa’ / ‘paludosus’ meaning ‘relating to a marsh’
palustris|From the Latin ‘palustris’ / ‘palustris’ meaning ‘relating to a marsh’
pandifolium|From the Latin ‘pandi’ / ‘pandus’ meaning ‘bent’; and the Latin ‘folium’ / ‘folium’ meaning ‘leaf’.
paniculata|From the Latin ‘paniculata’ / ‘paniculatus’ meaning ‘tufted’
paniculatum|From the Latin ‘paniculatum’ / ‘paniculatus’ meaning ‘tufted’
paniculatus|From the Latin ‘paniculatus’ / ‘paniculatus’ meaning ‘tufted’
paniculiformis|From the Latin ‘paniculi’ / ‘panicula’ meaning ‘tuft’; and the Latin ‘formis’ / ‘formis’ meaning ‘in the form of’.
papilionacea|From the Latin ‘papilionacea’ / ‘papilionaceus’ meaning ‘butterfly-like’
papillosa|From the Latin ‘papillosa’ / ‘papillosus’ meaning ‘equipped with nipples’
pappei|From the German ‘pappei’ / ‘Pappe’ meaning ‘commemorating a botanist of this name’
papulosum|From the Latin ‘papulosum’ / ‘pappulosus’ meaning ‘invested with hairy seeds’
papyracea|From the Latin ‘papyracea’ / ‘papyraceus’ meaning ‘papyrus-like’
paradoxa|From the Latin ‘paradoxa’ / ‘paradoxus’ meaning ‘paradoxical’
partita|From the Latin ‘partita’ / ‘partitus’ meaning ‘divided’
parva|From the Latin ‘parva’ / ‘parvus’ meaning ‘small’
parviflora|From the Latin ‘parvi’ / ‘parvus’ meaning ‘small’; and the Latin ‘flora’ / ‘flos’ meaning ‘flower’.
parviflorum|From the Latin ‘parvi’ / ‘parvus’ meaning ‘small’; and the Latin ‘florum’ / ‘flos’ meaning ‘flower’.
parvifolia|From the Latin ‘parvi’ / ‘parvus’ meaning ‘small’; and the Latin ‘folia’ / ‘folium’ meaning ‘leaf’.
parvula|From the Latin ‘parvula’ / ‘parvulus’ meaning ‘somewhat small’
parvulum|From the Latin ‘parvulum’ / ‘parvulus’ meaning ‘somewhat small’
patersonia|From the English ‘patersonia’ / ‘Paterson’ meaning ‘commemorating a botanist of this name’
patula|From the Latin ‘patula’ / ‘patulus’ meaning ‘standing open’
patulum|From the Latin ‘patulum’ / ‘patulus’ meaning ‘standing open’
pauciflora|From the Latin ‘pauci’ / ‘pauci’ meaning ‘few’; and the Latin ‘flora’ / ‘flos’ meaning ‘flower’.
pauciflorum|From the Latin ‘pauci’ / ‘pauci’ meaning ‘few’; and the Latin ‘florum’ / ‘flos’ meaning ‘flower’.
peacockiae|From the English ‘peacockiae’ / ‘Peacock’ meaning ‘commemorating a botanist of this name’
pectinata|From the Latin ‘pectinata’ / ‘pectinatus’ meaning ‘combed’
pectinatus|From the Latin ‘pectinatus’ / ‘pectinatus’ meaning ‘combed’
pedicellatus|From the Latin ‘pedicellatus’ / ‘pedicellatus’ meaning ‘covered with lice-like features’
pedunculata|From the Latin ‘pedunculata’ / ‘pedunculatus’ meaning ‘equipped with a stalk’
pellucida|From the Latin ‘pellucida’ / ‘transparent’ meaning ‘’
peltatum|From the Latin ‘peltatum’ / ‘peltatus’ meaning ‘armed with small crescent shields’
penicillata|From the Latin ‘penicillata’ / ‘penicillatus’ meaning ‘resembling a paintbrush’
peninsulae|From the Latin ‘peninsula’ / ‘peninsulae’ meaning ‘occurring in the Cape Peninsula’
peragua|From the Latin ‘peragua’ / ‘peraguus’ meaning ‘widespread’
perennis|From the Latin ‘perennis’ / ‘perennis’ meaning ‘perennial’
perfoliata|From the Latin ‘perfoliata’ / ‘perfoliatus’ meaning ‘entirely covered with leaves’
perigrinum|From the Latin ‘perigrinum’ / ‘perigrinus’ meaning ‘wandering’
perpensa|From the Latin ‘perpensa’ / ‘perpensus’ meaning ‘hung vertically’
perplexa|From the Latin ‘perplexa’ / ‘perplexus’ meaning ‘intricate’
perplexus|From the Latin ‘perplexus’ / ‘perplexus’ meaning ‘intricate’
personata|From the Latin ‘personata’ / ‘personata’ meaning ‘the plant called burdock’
pes-caprae|From the Latin ‘pes’ / ‘pes’ meaning ‘foot’; and the Latin ‘caprae’ / ‘capra’ meaning ‘sne-goat’.
petiolaris|From the Latin ‘petiolaris’ / ‘petiolaris’ meaning ‘equipped with a little foot’
phleoides|From the Greek ‘phle’ / ‘phloos?’ meaning ‘bark?’; and the Greek ‘oides’ / ‘oides’ meaning ‘in the form of’.
pholiuroides|From the Greek ‘pholi’ / ‘phollis?’ meaning ‘coin?’; and the Greek ‘oides’ / ‘oides’ meaning ‘in the form of’.
physodes|From the Greek ‘phys’ / ‘physe’ meaning ‘a pair of bellows’; and the Greek ‘odes’ / ‘oides’ meaning ‘in the form of’.
phyteuma|From the Greek ‘phyteuma’ / ‘phyteuma’ meaning ‘that which is planted’
pillansii|From the English ‘pillansii’ / ‘Pillans’ meaning ‘commemorating a botanist of this name’
pilosa|From the Latin ‘pilosa’ / ‘pilosus’ meaning ‘hairy’
pilosellifolia|From the Latin ‘piloselli’ / ‘pilosellus’ meaning ‘covered with tiny hairs’; and the Latin ‘folia’ / ‘folium’ meaning ‘leaf’.
piloselloides|From the Latin ‘piloselli’ / ‘pilosellus’ meaning ‘covered with tiny hairs’; and the Greek ‘oides’ / ‘oides’ meaning ‘in the form of’.
pilosum|From the Latin ‘pilosum’ / ‘pilosus’ meaning ‘hairy’
pilulifera|From the Latin ‘piluli’ / ‘pilulus’ meaning ‘tiny hair’; and the Latin ‘fera’ / ‘ferus’ meaning ‘bearing’.
pinaster|From the Latin ‘pinaster’ / ‘pinaster’ meaning ‘pine-tree’
pinguior|From the Latin ‘pinguior’ / ‘pinguior’ meaning ‘fatter’
pinifolia|From the Latin ‘pini’ / ‘pinus’ meaning ‘pine-tree’; and the Latin ‘folia’ / ‘folium’ meaning ‘leaf’.
pinifolium|From the Latin ‘pini’ / ‘pinus’ meaning ‘pine-tree’; and the Latin ‘folium’ / ‘folium’ meaning ‘leaf’.
pinifolius|From the Latin ‘pini’ / ‘pinus’ meaning ‘pine-tree’; and the Latin ‘folius’ / ‘folium’ meaning ‘leaf’.
pinnata|From the Latin ‘pinnata’ / ‘pinnatus’ meaning ‘feathered’
pinnatifida|From the Latin ‘pinnatifida’ / ‘pinnatifidus’ meaning ‘divided into feathers’
pinnatum|From the Latin ‘pinnatum’ / ‘pinnatus’ meaning ‘feathered’
pinnatus|From the Latin ‘pinnatus’ / ‘pinnatus’ meaning ‘feathered’
pinnulatus|From the Latin ‘pinnulatus’ / ‘pinnulatus’ meaning ‘covered in small feathers’
planifolia|From the Latin ‘plani’ / ‘planus’ meaning ‘flat’; and the Latin ‘folia’ / ‘folium’ meaning ‘leaf’.
plantagineus|From the Latin ‘plantagineus’ / ‘plantagineus’ meaning ‘resembling a plantain’
plantago-aquatica|From the Latin ‘plantago’ / ‘plantago’ meaning ‘plantain’; and the Latin ‘aquatica’ / ‘aquaticus’ meaning ‘relating to water’.
platypetalum|From the Greek ‘plat y’ / ‘platys’ meaning ‘broad’; and the Greek ‘petalum’ / ‘petalon’ meaning ‘petal’.
plicatum|From the Latin ‘plicatum’ / ‘plicatus’ meaning ‘folded’
plukenetiana|From the English ‘plunketiana’ / ‘Plunkenet’ meaning ‘commemorating a botanist of this name’
plukenetii|From the English ‘plunkenetii’ / ‘Plunkenet’ meaning ‘commemorating a botanist of this name’
plumosa|From the Latin ‘plumosa’ / ‘plumosus’ meaning ‘feathered’
plurisectum|From the Latin ‘pluri’ / ‘pluri’ meaning ‘many’; and the Latin ‘sectum’ / ‘sectus’ meaning ‘cut’.
pluvialis|From the Latin ‘pluvialis’ / ‘pluvialis’ meaning ‘prompted by rain’
pocockiae|From the English ‘pocockiae’ / ‘Pocock’ meaning ‘commemorating a botanist of this name’
poiretii|From the French ‘poiretii’ / ‘Poiret’ meaning ‘commemorating a botanist of this name’
polifolia|From the Latin ‘poli’ / ‘polus’ meaning ‘the end of an axis’; and the Latin ‘folia’ / ‘folium’ meaning ‘leaf’.
polygaloides|From the Greek ‘polygal’ / ‘polygala’ meaning ‘a fabaceous shrub’; and the Greek ‘oides’ / ‘oides’ meaning ‘in the form of’.
polygonifolia|From the Greek ‘polygoni’ / ‘polygon’ meaning ‘polygon’; and the Latin ‘folia’ / ‘folium’ meaning ‘leaf’.
polygonoides|From the Greek ‘polygon’ / ‘polygon’ meaning ‘polygon’; and the Greek ‘oides’ / ‘oides’ meaning ‘in the form of’.
polyphylla|From the Greek ‘poly’ / ‘poly’ meaning ‘many’; and the Greek ‘phylla’ / ‘phyllon’ meaning ‘leaf’.
polypodioides|From the Greek ‘polypdi’ / ‘polypodos???’ meaning ‘a plant having a many-legged appearance????’; and the Greek ‘oides’ / ‘oides’ meaning ‘in the form of’.
polypogonoides|From the Greek ‘polypogon’ / ‘polypogon’ meaning ‘a bearded plant’; and the Greek ‘oides’ / ‘oides’ meaning ‘in the form of’.
polystachya|From the Greek ‘poly’ / ‘poly’ meaning ‘many’; and the Greek ‘stachya’ / ‘stachys’ meaning ‘spike’.
polystachyos|From the Greek ‘poly’ / ‘poly’ meaning ‘many’; and the Greek ‘stachos’ / ‘stachys’ meaning ‘spike’.
pomeridiana|From the Latin ‘pomeridiana’ / ‘pomeridianus’ meaning ‘relating to the afternoon’
populifolia|From the Latin ‘populi’ / ‘populus’ meaning ‘poplar’; and the Latin ‘folia’ / ‘folium’ meaning ‘leaf’.
porosus|From the Latin ‘porosus’ / ‘porosus’ meaning ‘bearing pores’
praemorsa|From the Latin ‘praemorsa’ / ‘praemorsus’ meaning ‘nibbled in the forepart’
pratensis|From the Latin ‘pratensis’ / ‘pratensis’ meaning ‘relating to meadows’
priorii|From the English ‘priorii’ / ‘Prior’ meaning ‘commemorating a botanist of this name’
prismatocarpa|From the Greek ‘prismato’ / ‘prismatos’ meaning ‘sawn’; and the Greek ‘carpa’ / ‘karpos’ meaning ‘fruit’.
procumbens|From the Latin ‘procumbens’ / ‘procumbens’ meaning ‘lying down’
prolifera|From the Latin ‘prolifera’ / ‘proliferus’ meaning ‘bearing much fruit or many flowers’
prominens|From the Latin ‘prominens’ / ‘prominens’ meaning ‘standing out’
promontorii|From the Latin ‘promontorii’ / ‘promontorius’ meaning ‘relating to a promontary, ie the Cape????’
prostrata|From the Latin ‘prostrata’ / ‘prostratus’ meaning ‘lying down’
prostratum|From the Latin ‘prostratum’ / ‘prostratus’ meaning ‘lying down’
proteoides|From the Greek ‘prote’ / ‘protea’ meaning ‘the flower named after the Greek god of change’; and the Greek ‘oides’ / ‘oides’ meaning ‘in the form of’.
pruinosa|From the Latin ‘pruinosa’ / ‘pruinosus’ meaning ‘frosty’
pseudocapsicum|From the Greek ‘pseudo’ / ‘pseudes’ meaning ‘untrue (I can't type false)’; and the Latin ‘capsicum’ / ‘capsicum’ meaning ‘pepper’.
pseudovirgatum|From the Greek ‘pseudo’ / ‘pseudes’ meaning ‘untrue (I can't type false)’; and the Latin ‘virgatum’ / ‘virgatus’ meaning ‘made of twigs’.
psoraleoides|From the Greek ‘psorale’ / ‘psoralea’ meaning ‘a plant of a warty appearance’; and the Greek ‘oides’ / ‘oides’ meaning ‘in the form of’.
pterocarpa|From the Greek ‘ptero’ / ‘pteron’ meaning ‘wing’; and the Greek ‘carpus’ / ‘karpos’ meaning ‘fruit’.
pteroides|From the Greek ‘pter’ / ‘pteron’ meaning ‘wing’; and the Greek ‘oides’ / ‘oides’ meaning ‘in the form of’.
pterophorus|From the Greek ‘ptero’ / ‘pteron’ meaning ‘wing’; and the Greek ‘phorus’ / ‘phoros’ meaning ‘bearing’.
pubescens|From the Latin ‘pubescens’ / ‘pubescens’ meaning ‘becoming downy’
pubigerus|From the Latin ‘pubigerus’ / ‘pubigerus’ meaning ‘bearing down’
pugioniformis|From the Latin ‘pugnioni’ / ‘pugnus’ meaning ‘fist’; and the Latin ‘formis’ / ‘formis’ meaning ‘in the form of’.
pulchella|From the Latin ‘pulchella’ / ‘pulchellus’ meaning ‘beautiful and small’
pulverulenta|From the Latin ‘pulverulenta’ / ‘pulverulentus’ meaning ‘dusty’
pumilum|From the Latin ‘pumilum’ / ‘pumilus’ meaning ‘dwarfish’
punctata   |From the Latin ‘punctata’ / ‘punctatus’ meaning ‘punctured or pock-marked’
punctatus|From the Latin ‘puctatus’ / ‘punctatus’ meaning ‘punctured or pock-marked’
punctoria|From the Latin ‘puctoria’ / ‘punctorius’ meaning ‘resembling a pricker’
punctorius|From the Latin ‘punctorius’ / ‘punctorius’ meaning ‘resembling a pricker’
punctulatum|From the Latin ‘punctulatum’ / ‘punctulatus’ meaning ‘slightly pock-marked’
pungens|From the Latin ‘pungens’ / ‘pungens’ meaning ‘prickly’
purpurascens|From the Latin ‘purpurascens’ / ‘purpurascens’ meaning ‘becoming purple’
purpurea|From the Latin ‘purpurea’ / ‘purpureus’ meaning ‘purple’
purpureus|From the Latin ‘purpureus’ / ‘purpureus’ meaning ‘purple’
pusilla|From the Latin ‘pusilla’ / ‘pusillus’ meaning ‘very small’
pusillus|From the Latin ‘pusillus’ / ‘pusillus’ meaning ‘very small’
pustulata|From the Latin ‘pustulata’ / ‘pustulatus’ meaning ‘blistered’
pycnantha|From the Greek ‘pcyn’ / ‘pyknos’ meaning ‘dense’; and the Greek ‘antha’ / ‘anthos’ meaning ‘flower’.
pygmaea|From the Latin ‘pygmaea’ / ‘pygmaea’ meaning ‘dwarfish’
pyracantha|From the Greek ‘pyra’ / ‘pyr’ meaning ‘fire’; and the Greek ‘acantha’ / ‘akantha’ meaning ‘thorn’.
pyramidalis|From the Latin ‘pyrmidalis’ / ‘pyramidalis’ meaning ‘pyramid-shaped’
pyrophila|From the Greek ‘pyro’ / ‘pyr’ meaning ‘fire’; and the Greek ‘phila’ / ‘philein’ meaning ‘love’.
pyxidiflora|From the Greek ‘pyxidi’ / ‘pyxidion’ meaning ‘small box’; and the Latin ‘flora’ / ‘flos’ meaning ‘flower’.
quadrangularis|From the Latin ‘quadrangularis’ / ‘quadrangularis’ meaning ‘quadrangular’
quadrangulus|From the Latin ‘quandrangulus’ / ‘quadrangulus’ meaning ‘quadrangular’
quadratus|From the Latin ‘quadratus’ / ‘quadratus’ meaning ‘quartered’
quadrifolium|From the Latin ‘quadri’ / ‘quadrus’ meaning ‘square’; and the Latin ‘folium’ / ‘folium’ meaning ‘leaf’.
quadrisepala|From the Latin ‘quadri’ / ‘quadrus’ meaning ‘square’; and the Latin ‘sepala’ / ‘sepulus’ meaning ‘sepal’.
quadrisulcata|From the Latin ‘quadri’ / ‘quadrus’ meaning ‘square’; and the Latin ‘sulcatus’ / ‘sulcatus’ meaning ‘furrowed’.
quercifolia|From the Latin ‘querci’ / ‘quercus’ meaning ‘oak’; and the Latin ‘folia’ / ‘folium’ meaning ‘leaf’.
quinquedentata  Thunberg|From the Latin ‘quinque’ / ‘quinque’ meaning ‘five’; and the Latin ‘dentata’ / ‘dentatus’ meaning ‘toothed’.
quinquefarius|From the Latin ‘quinque’ / ‘quinque’ meaning ‘five’; and the Latin ‘farius’ / ‘farius??? No such word’ meaning ‘speaking????’.
quinquefolia|From the Latin ‘quinque’ / ‘quinque’ meaning ‘five’; and the Latin ‘folia’ / ‘folium’ meaning ‘leaf’.
racemosa|From the Latin ‘racemosa’ / ‘racemosus’ meaning ‘clustered’
racemosus|From the Latin ‘racemosus’ / ‘racemosus’ meaning ‘clustered’
radens|From the Latin ‘radens’ / ‘radens?????’ meaning ‘rooting????’
radiata|From the Latin ‘radiata’ / ‘radiatus’ meaning ‘radiating’
radulifolium|From the Latin ‘raduli’ / ‘radula’ meaning ‘scraper’; and the Latin ‘folium’ / ‘folium’ meaning ‘leaf’.
ramentacea|From the Latin ‘ramentacea’ / ‘ramentaceus’ meaning ‘resembling shavings’
ramosa|From the Latin ‘ramosa’ / ‘ramosus’ meaning ‘branched’
ramosissima|From the Latin ‘ramossisima’ / ‘ramossisimus’ meaning ‘excessively branched’
rangei|From the German ‘rangei’ / ‘Range’ meaning ‘commemorating a botanist of this name’
rapaceum|From the Latin ‘rapaceum’ / ‘rapaceus?’ meaning ‘greedy (of space)?’
rapunculoides|From the Latin ‘rapuncul’ / ‘rapunculus’ meaning ‘a little turnip’; and the Greek ‘oides’ / ‘oides’ meaning ‘in the form of’.
rariflorum|From the Latin ‘rari’ / ‘rarus’ meaning ‘rare’; and the Latin ‘florum’ / ‘flos’ meaning ‘flower’.
recognita|From the Latin ‘recognita’ / ‘recognitus’ meaning ‘reviewed??? Overlooking???’
rectum|From the Latin ‘rectum’ / ‘rectus’ meaning ‘straight’
recurvata|From the Latin ‘recurvata’ / ‘recurvatus’ meaning ‘curved back’
reflexa|From the Latin ‘reflexa’ / ‘reflexus’ meaning ‘bending back’
refracta|From the Latin ‘refracta’ / ‘refractus’ meaning ‘bent back’
rehmannii|From the German ‘rehmannii’ / ‘Rehmann’ meaning ‘commemorating a botanist of this name’
remota|From the Latin ‘remota’ / ‘remotus’ meaning ‘remote’
repandus|From the Latin ‘repandus’ / ‘repandus’ meaning ‘opening back’
repens|From the Latin ‘repens’ / ‘repens’ meaning ‘creeping’
reptans|From the Latin ‘reptans’ / ‘reptans’ meaning ‘creeping’
restioides|From the Greek ‘resti’ / ‘restio’ meaning ‘a grass-like plant’; and the Greek ‘oides’ / ‘oides’ meaning ‘in the form of’.
reticulata|From the Latin ‘reticulata’ / ‘reticulatus’ meaning ‘net-like’
retortum|From the Latin ‘retortum’ / ‘retortus’ meaning ‘bent back’
retroflexa|From the Latin ‘retroflexa’ / ‘retroflexus’ meaning ‘bending back’
retrofractus|From the Latin ‘retrofractus’ / ‘retrofractus’ meaning ‘bent back’
retusum|From the Latin ‘retusum’ / ‘retusus’ meaning ‘blunt’
revoluta|From the Latin ‘revoluta’ / ‘revolutus’ meaning ‘turned round’
revolutum|From the Latin ‘revolutum’ / ‘revolutus’ meaning ‘turned round’
rhinocerotis|From the Greek ‘rhinocer’ / ‘rhinoceros’ meaning ‘rhinoceros’; and the Greek ‘otis’ / ‘otis’ meaning ‘ear’.
rhyncanthum|From the Greek ‘rhync’ / ‘rhynkos’ meaning ‘snout’; and the Greek ‘anthum’ / ‘anthos’ meaning ‘flower’.
richardiana|From the English ‘richardiana’ / ‘Richard’ meaning ‘commemorating a botanist of this name’
rigida|From the Latin ‘rigida’ / ‘rigidus’ meaning ‘rigid’
rigidifolia|From the Latin ‘rigidi’ / ‘rigidus’ meaning ‘rigid’; and the Latin ‘folia’ / ‘folium’ meaning ‘leaf’.
rigidissima|From the Latin ‘rigidissima’ / ‘rigidissimus’ meaning ‘very rigid’
rigidum|From the Latin ‘rigidum’ / ‘rigidus’ meaning ‘rigid’
rigidus|From the Latin ‘rigidus’ / ‘rigidus’ meaning ‘rigid’
ringens|From the Latin ‘ringens’ / ‘ringens’ meaning ‘gaping’
rosea|From the Latin ‘rosea’ / ‘roseus’ meaning ‘rose-coloured’
rosmarinifolia|From the Latin ‘rosmarini’ / ‘rosmarinus’ meaning ‘the herb rosemary’; and the Latin ‘folia’ / ‘folium’ meaning ‘leaf’.
rosmarinifolius|From the Latin ‘rosmarini’ / ‘rosmarinus’ meaning ‘the herb rosemary’; and the Latin ‘folius’ / ‘folium’ meaning ‘leaf’.
rostratus|From the Latin ‘rostratus’ / ‘rostratus’ meaning ‘beaked’
rotundifolium|From the Latin ‘rotundi’ / ‘rotundus’ meaning ‘round’; and the Latin ‘folium’ / ‘folium’ meaning ‘leaf’.
rubicunda|From the Latin ‘rubicunda’ / ‘rubicundus’ meaning ‘red’
rubicundis|From the Latin ‘rubicundis’ / ‘rubicundus’ meaning ‘red’
rubida|From the Latin ‘rubida’ / ‘rubidus’ meaning ‘red’
rubiginosa|From the Latin ‘rubiginosa’ / ‘rubiginosus’ meaning ‘red’
rubra|From the Latin ‘rubra’ / ‘ruber’ meaning ‘red’
rubricaulis|From the Latin ‘rubri’ / ‘ruber’ meaning ‘red’; and the Latin ‘caulis’ / ‘caulis’ meaning ‘stalk’.
rubrum|From the Latin ‘rubrum’ / ‘ruber’ meaning ‘red’
rudis|From the Latin ‘rudis’ / ‘rudis’ meaning ‘slender stick’
rufa|From the Latin ‘rufa’ / ‘rufus’ meaning ‘red’
rufescens|From the Latin ‘rufescens’ / ‘rufescens’ meaning ‘reddening’
rugosa|From the Latin ‘rugosa’ / ‘rugosus’ meaning ‘wrinkled’
rugosus|From the Latin ‘rugosus’ / ‘rugosus’ meaning ‘wrinkled’
rupestris|From the Latin ‘rupestris’ / ‘rupestis’ meaning ‘associated with caves or rocks’
ruscifolia|From the Latin ‘rusci’ / ‘ruscus’ meaning ‘the plant called butcher's broom’; and the Latin ‘folia’ / ‘folium’ meaning ‘leaf’.
sabulosa|From the Latin ‘sabulosa’ / ‘sabulosus’ meaning ‘sandy’
sabulosum|From the Latin ‘sabulosum’ / ‘sabulosus’ meaning ‘sandy’
saggitatus|From the Latin ‘saggitatus’ / ‘saggitatus’ meaning ‘equipped with arrows’
sagittatum|From the Latin ‘saggitatum’ / ‘saggitatus’ meaning ‘equipped with arrows’
saligna|From the Latin ‘saligna’ / ‘salignus’ meaning ‘relating to willows’
salignum|From the Latin ‘salignum’ / ‘salignus’ meaning ‘relating to willows’
salteri|From the English ‘salter’ / ‘Salter’ meaning ‘commemorating a botanist of this name’
salviifolia|From the Latin ‘salvii’ / ‘salvia’ meaning ‘sage’; and the Latin ‘folia’ / ‘folium’ meaning ‘leaf’.
sanguinalis|From the Latin ‘sanguinalis’ / ‘sanguinalis’ meaning ‘bloody’
sanguinea|From the Latin ‘sanguinea’ / ‘sanguineus’ meaning ‘blood-red’
sanguineus|From the Latin ‘sanguineus’ / ‘sanguineus’ meaning ‘blood-red’
sarcocladus|From the Greek ‘sarco’ / ‘sarkos’ meaning ‘flesh’; and the Greek ‘cladus’ / ‘klados’ meaning ‘twig’.
sarcocolla|From the Greek ‘sarco’ / ‘sarkos’ meaning ‘flesh’; and the Latin ‘collus’ / ‘collum’ meaning ‘neck’.
sarcoides|From the Greek ‘sarc’ / ‘sarkos’ meaning ‘flesh’; and the Greek ‘oides’ / ‘oides’ meaning ‘in the form of’.
sarmentosa|From the Latin ‘sarmentosa’ / ‘sarmentosus’ meaning ‘twiggy’
sarmentosum|From the Latin ‘sarmentosum’ / ‘sarmentosus’ meaning ‘twiggy’
sarniensis|From the English ‘sarniensis’ / ‘Sarnia’ meaning ‘a region in Canada’
sativa|From the Latin ‘sativa’ / ‘sativus’ meaning ‘cultivated’
satureioides|From the Latin ‘saturei’ / ‘satureia’ meaning ‘the pot-herb cunila’; and the Greek ‘oides’ / ‘oides’ meaning ‘in the form of’.
saxifraga|From the Latin ‘saxi’ / ‘saxum’ meaning ‘boulder’; and the Latin ‘fraga’ / ‘fragans’ meaning ‘breaking’.
scabra|From the Latin ‘scabra’ / ‘scaber’ meaning ‘scabby’
scabrida|From the Latin ‘scabrida’ / ‘scabridus’ meaning ‘rough’
scabriusculus|From the Latin ‘scabriusculus’ / ‘scabriusculus’ meaning ‘a little rougher’
scabrosa|From the Latin ‘scabrosa’ / ‘scabrosus’ meaning ‘rough’
scabrum|From the Latin ‘scabrum’ / ‘scaber’ meaning ‘rough’
scandens|From the Latin ‘scandens’ / ‘scandens’ meaning ‘climbing’
scapiflorus|From the Latin ‘scapi’ / ‘scapus’ meaning ‘sheet of paper’; and the Latin ‘florus’ / ‘flos’ meaning ‘flower’.
schinoides|From the Greek ‘schin’ / ‘schinos’ meaning ‘pepper-tree’; and the Greek ‘oides’ / ‘oides’ meaning ‘in the form of’.
schlechteri|From the German ‘schlecteri’ / ‘Schlecter’ meaning ‘commemorating a botanist of this name’
schlechterianum|From the German ‘schlecterianum’ / ‘Schlecter’ meaning ‘commemorating a botanist of this name’
schumannianum|From the German ‘schumannianum’ / ‘Schumann’ meaning ‘commemorating a botanist of this name’
scillaris|From the Latin ‘scillaris’ / ‘scillaris’ meaning ‘resembling a sea-onion’
scirpoideus|From the Latin ‘scirp’ / ‘scirpus’ meaning ‘reed’; and the Greek ‘oides’ / ‘oides’ meaning ‘in the form of’.
scolymocephala|From the Greek ‘scolymo’ / ‘skolymos’ meaning ‘artichoke’; and the Greek ‘cephala’ / ‘kephale’ meaning ‘head’.
scoparia|From the Latin ‘scopraria’ / ‘scoprarius’ meaning ‘sweeper’
scorzonerifolia|From the Italian ‘scorzoneri’ / ‘scorzonero’ meaning ‘relating to bark’; and the Latin ‘folia’ / ‘folium’ meaning ‘leaf’.
secunda|From the Latin ‘secundus’ / ‘second’ meaning ‘’
secundatum|From the Latin ‘secundatum’ / ‘secundatus’ meaning ‘adapted’
sedifolium|From the Latin ‘sedi’ / ‘sedum’ meaning ‘leek’; and the Latin ‘folium’ / ‘folium’ meaning ‘leaf’.
selloana|From the Latin? ‘selloana/sellariolus’ / ‘sello/seat-like’ meaning ‘commemorating a botanist of this name?’
semibaccata|From the Latin ‘semibaccata’ / ‘semibaccatus’ meaning ‘half endowed with berries’
semiquinquefidum|From the Latin ‘semquinquefidum’ / ‘semiquinquefidushalf divided into fives’ meaning ‘’
senecioides|From the Latin ‘seneci’ / ‘senecio’ meaning ‘groundsel’; and the Greek ‘oides’ / ‘oides’ meaning ‘in the form of’.
sericea|From the Latin ‘sericea’ / ‘sericeus’ meaning ‘silky’
serpens|From the Latin ‘serpens’ / ‘serpens’ meaning ‘creeping’
serpyllacea|From the Latin ‘serpyllacea’ / ‘serpyllaceus’ meaning ‘resembling thyme’
serpyllifolia|From the Latin ‘serpylli’ / ‘serpyllum’ meaning ‘thyme’; and the Latin ‘folia’ / ‘folium’ meaning ‘leaf’.
serpylloides|From the Latin ‘serpyll’ / ‘serpyllum’ meaning ‘thyme’; and the Greek ‘oides’ / ‘oides’ meaning ‘in the form of’.
serrata|From the Latin ‘serrata’ / ‘serratus’ meaning ‘serrated’
serratum|From the Latin ‘serratus’ / ‘serratus’ meaning ‘serrated’
sesamoides|From the Latin ‘sesam’ / ‘sesamum’ meaning ‘oily plant’; and the Greek ‘oides’ / ‘oides’ meaning ‘in the form of’.
sessiliflora|From the Latin ‘sessili’ / ‘sessilis’ meaning ‘spreading’; and the Latin ‘flora’ / ‘flos’ meaning ‘flower’.
sessiliflorum|From the Latin ‘sessili’ / ‘sessilis’ meaning ‘spreading’; and the Latin ‘florum’ / ‘flos’ meaning ‘flower’.
sessilifolium|From the Latin ‘sessili’ / ‘sessilis’ meaning ‘spreading’; and the Latin ‘folium’ / ‘folium’ meaning ‘leaf’.
sessilis|From the Latin ‘sessilis’ / ‘sessilis’ meaning ‘spreading’
setacea|From the Latin ‘setacea’ / ‘setaceus’ meaning ‘bristly’
setaceum|From the Latin ‘setaceum’ / ‘setaceus’ meaning ‘bristly’
setifolia|From the Latin ‘seti’ / ‘setum’ meaning ‘bristle’; and the Latin ‘folia’ / ‘folium’ meaning ‘leaf’.
setiger|From the Latin ‘seti’ / ‘setum’ meaning ‘bristle’; and the Latin ‘ger’ / ‘gerus’ meaning ‘wielding’.
setosa|From the Latin ‘setosa’ / ‘setosus’ meaning ‘bristly’
sexfaria|From the Latin ‘sex’ / ‘sex’ meaning ‘six’; and the Latin ‘faria’ / ‘farius??? No such word’ meaning ‘speaking????’.
sieberi|From the German ‘sieberi’ / ‘Sieber’ meaning ‘commemorating a botanist of this name’
silenifolia|From the Latin ‘sileni’ / ‘silene’ meaning ‘a carnation-like kind of plant’; and the Latin ‘folia’ / ‘folium’ meaning ‘leaf’.
silenoides|From the Latin ‘silen’ / ‘silene’ meaning ‘a carnation-like kind of plant’; and the Greek ‘oides’ / ‘oides’ meaning ‘in the form of’.
similis|From the Latin ‘similis’ / ‘similis’ meaning ‘similar’
simplex|From the Latin ‘simplex’ / ‘simplex’ meaning ‘simple’
sociorum|From the Latin ‘sociorum’ / ‘sociorum’ meaning ‘of the allies’
solitaria|From the Latin ‘solitaria’ / ‘solitarius’ meaning ‘solitary’
sparsisora|From the Latin ‘sparsi’ / ‘sparsus’ meaning ‘sparse’; and the Latin ‘????misprint?’ / ‘????’ meaning ‘????’.
sparteum|From the Latin ‘sparteum’ / ‘sparteus’ meaning ‘resembling the plant called broom’
spathalum|From the Latin ‘spathulum’ / ‘spathulum’ meaning ‘a broad  piece’
speciosa|From the Latin ‘speciosa’ / ‘speciosus’ meaning ‘beautiful’
speciosissima|From the Latin ‘speciocissima’ / ‘speciossisimus’ meaning ‘most beautiful’
speciosus|From the Latin ‘speciosus’ / ‘speciosus’ meaning ‘beautiful’
spermacoccea|From the Greek ‘sperma’ / ‘sperma’ meaning ‘seed’; and the Latin ‘coccea’ / ‘cocceus’ meaning ‘invested with berries’.
sphacelata|From the Greek ‘sphacelata’ / ‘sphakelatos’ meaning ‘gangrened’
sphaerospermus|From the Greek ‘sphaero’ / ‘sphaeros’ meaning ‘sphere’; and the Greek ‘spermus’ / ‘sperma’ meaning ‘seed’.
spicata|From the Latin ‘spicata’ / ‘spicatus’ meaning ‘spiked’
spicatum|From the Latin ‘spicatum’ / ‘spicatus’ meaning ‘spiked’
spicatus|From the Latin ‘spicatus’ / ‘spicatus’ meaning ‘spiked’
spicigerus|From the Latin ‘spici’ / ‘spica’ meaning ‘spike’; and the Latin ‘gerus’ / ‘gerus’ meaning ‘wielding’.
spiniformis|From the Latin ‘spini’ / ‘spina’ meaning ‘thorn’; and the Latin ‘formis’ / ‘formis’ meaning ‘formis’.
spinosa|From the Latin ‘spinosa’ / ‘spinosus’ meaning ‘thorny’
spinosum|From the Latin ‘spinosum’ / ‘spinosus’ meaning ‘thorny’
spinulosum|From the Latin ‘spinulosum’ / ‘spinulosus’ meaning ‘somewhat thorny’
spirale|From the Latin ‘spirale’ / ‘spiralis’ meaning ‘spiral’
spiralepis|From the Latin ‘spira’ / ‘spiralis’ meaning ‘spiral’; and the Greek ‘lepis’ / ‘lepis’ meaning ‘scale’.
spiralis|From the Latin ‘spiralis’ / ‘spiralis’ meaning ‘spiral’
spissifolium|From the Latin ‘spissi’ / ‘spissus’ meaning ‘thick or dense’; and the Latin ‘folium’ / ‘folium’ meaning ‘leaf’.
splendens|From the Latin ‘splendens’ / ‘splendens’ meaning ‘splendid’
sporadicus|From the Latin ‘sporadicus’ / ‘sporadicus’ meaning ‘sporadic’
spumosa|From the Latin ‘spumosa’ / ‘spumosus’ meaning ‘foamy’
spuria|From the Latin ‘spuria’ / ‘spurius’ meaning ‘inauthentic’
spurium|From the Latin ‘spurium’ / ‘spurius’ meaning ‘inauthentic’
squamosa|From the Latin ‘squamosa’ / ‘squamosus’ meaning ‘scaly’
squarrosa|From the Latin ‘squarrosa’ / ‘squarrosus’ meaning ‘scurfy’
steenbergensis|From the Dutch ‘steenbergensis’ / ‘relating to the Steenberg in South Africa’ meaning ‘’
stellata|From the Latin ‘stelllata’ / ‘stellatus’ meaning ‘made star-like’
stellatifolium|From the Latin ‘stellati’ / ‘stellatus’ meaning ‘made star-like’; and the Latin ‘folium’ / ‘folium’ meaning ‘leaf’.
stellenbossiensis|From the Dutch ‘stellenbossiensis’ / ‘Stellenbosch’ meaning ‘relating to the town of Stellenbosch’
stenopetalum|From the Greek ‘steno’ / ‘stenos’ meaning ‘short’; and the Greek ‘petalum’ / ‘petalon’ meaning ‘petal’.
stenopetalus|From the Greek ‘steno’ / ‘stenos’ meaning ‘short’; and the Greek ‘petalus’ / ‘petalon’ meaning ‘petal’.
stenophylla|From the Greek ‘steno’ / ‘stenos’ meaning ‘short’; and the Greek ‘phylla’ / ‘phyllon’ meaning ‘leaf’.
stenus|From the Greek ‘stenus’ / ‘stenos’ meaning ‘short’
sterilis|From the Latin ‘sterilis’ / ‘sterilis’ meaning ‘sterile’
stipitata|From the Latin ‘stipitata’ / ‘stipitatus????’ meaning ‘resembling a log????’
stipulacea|From the Latin ‘stipulacea’ / ‘stipulaceus’ meaning ‘straw-like’
stipulaceum|From the Latin ‘stipulaceum’ / ‘stipulaceus’ meaning ‘straw-like’
stipulaceus|From the Latin ‘stipulaceum’ / ‘stipulaceus’ meaning ‘straw-like’
stipularis|From the Latin ‘stipularis’ / ‘stipularis’ meaning ‘straw-like’
stoechadifolia|From the Greek ‘stoechadi’ / ‘stoechas’ meaning ‘lavender’; and the Latin ‘folia’ / ‘folium’ meaning ‘leaf’.
stokoei|From the English ‘stokoei’ / ‘Stokoe’ meaning ‘commemorating a botanist of this name’
stolonifera|From the Latin ‘stoloni’ / ‘stolo’ meaning ‘sucker’; and the Latin ‘fera’ / ‘ferus’ meaning ‘bearing’.
striata|From the Latin ‘striata’ / ‘striatus’ meaning ‘striped’
striatum|From the Latin ‘striatum’ / ‘striatus’ meaning ‘striped’
stricta|From the Latin ‘stricta’ / ‘strictus’ meaning ‘compressed’
strictum|From the Latin ‘strictum’ / ‘strictus’ meaning ‘compressed’
strictus|From the Latin ‘strictus’ / ‘strictus’ meaning ‘compressed’
strigosa|From the Latin ‘strigosa’ / ‘strigosus’ meaning ‘lank’
strobilifera|From the Latin ‘strobili’ / ‘strobilus’ meaning ‘pine-cone’; and the Latin ‘fera’ / ‘ferus’ meaning ‘bearing’.
strobilinum|From the Greek ‘strobilinum’ / ‘strobilinum’ meaning ‘a little pine-cone’
suaveolens|From the Latin ‘suave’ / ‘suave’ meaning ‘pleasantly’; and the Latin ‘olens’ / ‘olens’ meaning ‘smelling’.
subcapitata|From the Latin ‘subcapitata’ / ‘subcapitatus’ meaning ‘with heads below’
subdivaricata|From the Latin ‘subdivaricata’ / ‘subdivaricatus’ meaning ‘branching below’
subsetacea|From the Latin ‘subsetacea’ / ‘subsetaceus’ meaning ‘with bristles below’
subulata|From the Latin ‘subulata’ / ‘subulatus’ meaning ‘with  awls below’
succotrina|From the ???? ‘succotrina’ / ‘succotrinus’ meaning ‘deriving from the island of Sokotra’
suffruticosum|From the Latin ‘suffruticosum’ / ‘suffruticosus’ meaning ‘bushy below’
sulcata|From the Latin ‘sulcata’ / ‘sulcatus’ meaning ‘furrowed’
sulphurea|From the Latin ‘sulphurea’ / ‘sulphureus’ meaning ‘yellow’
sylvatica|From the Latin ‘sylvatica’ / ‘sylvaticus’ meaning ‘pertaining to woodland’
tabulare|From the Latin ‘tabulare’ / ‘tabularis’ meaning ‘tabular’
tabularis|From the Latin ‘tabularis’ / ‘tabularis’ meaning ‘tabular’
tagetes|From the Etruscan ‘tagetes’ / ‘Tages’ meaning ‘a city in Etruria’
taxifolia|From the Latin ‘taxi’ / ‘taxus’ meaning ‘yew’; and the Latin ‘folia’ / ‘folium’ meaning ‘leaf’.
tectorum|From the Latin ‘tectorum’ / ‘tecti’ meaning ‘roofs’
tegens|From the Latin ‘tegens’ / ‘tegens’ meaning ‘covering’
telipogonis|From the Greek? ‘’ / ‘tele?’ meaning ‘far off?’; and the Greek ‘pogonis’ / ‘pogon’ meaning ‘beard’.
temulentum|From the Latin ‘temulentum’ / ‘temulentus’ meaning ‘drunken’
tenella|From the Latin ‘tenella’ / ‘tenellus’ meaning ‘somewhat tender’
tenellus|From the Latin ‘tenellus’ / ‘tenellus’ meaning ‘somewhat tender’
tenuicornis|From the Latin ‘tenui’ / ‘tenuus’ meaning ‘fine or sparse’; and the Latin ‘cornis’ / ‘cornus’ meaning ‘horn’.
tenuifolia|From the Latin ‘tenui’ / ‘tenuus’ meaning ‘fine or sparse’; and the Latin ‘folia’ / ‘folium’ meaning ‘leaf’.
tenuifolium|From the Latin ‘tenui’ / ‘tenuus’ meaning ‘fine or sparse’; and the Latin ‘folium’ / ‘folium’ meaning ‘leaf’.
tenuifolius|From the Latin ‘tenui’ / ‘tenuus’ meaning ‘fine or sparse’; and the Latin ‘folius’ / ‘folium’ meaning ‘leaf’.
tenuis|From the Latin ‘tenuis’ / ‘tenuis’ meaning ‘fine’
tenuissima|From the Latin ‘tenuissima’ / ‘tenuissimus’ meaning ‘extremely fine’
teretifolia|From the Latin ‘tereti’ / ‘teres’ meaning ‘rounded’; and the Latin ‘folia’ / ‘folium’ meaning ‘leaf’.
teretifolium|From the Latin ‘tereti’ / ‘teres’ meaning ‘rounded’; and the Latin ‘folium’ / ‘folium’ meaning ‘leaf’.
ternata|From the Latin ‘ternata’ / ‘ternatus’ meaning ‘divided into three’
ternifolia|From the Latin ‘terni’ / ‘terni’ meaning ‘having three each’; and the Latin ‘folia’ / ‘folium’ meaning ‘leaf’.
terrestris|From the Latin ‘terrestris’ / ‘terrestris’ meaning ‘relating to the earth’
tetragona|From the Latin ‘tetragona’ / ‘tetragonus’ meaning ‘having four sides’
tetragonum|From the Latin ‘tetragonum’ / ‘tetragonus’ meaning ‘having four sides’
tetragonus|From the Latin ‘tetragonus’ / ‘tetragonus’ meaning ‘having four sides’
tetraphyllum|From the Greek ‘tetra’ / ‘tetra’ meaning ‘four’; and the Greek ‘phyllum’ / ‘phyllon’ meaning ‘leaf’.
textilis|From the Latin ‘textilis’ / ‘textilis’ meaning ‘woven’
thelliana|From the German? ‘thelliana’ / ‘Thell?’ meaning ‘commemorating a botanist of this name’
theodori-friesii|From the Dutch ‘theodori-friessii’ / ‘Theodorus Friesius’ meaning ‘commemorating a botanist of this name’
thermalis|From the Latin ‘thermalis’ / ‘thermalis’ meaning ‘relating to hot springs’
thesioides|From the Greek ‘thesio’ / ‘thesion’ meaning ‘toad-flax’; and the Greek ‘oides’ / ‘olens’ meaning ‘in the form of’.
thimifolia|From the Latin ‘thimi’ / ‘thimum’ meaning ‘thyme’; and the Latin ‘folia’ / ‘folium’ meaning ‘leaf’.
thomii|From the Dutch ‘thomii’ / ‘Thom’ meaning ‘commemorating a botanist of this name’
thunbergiana|From the Swedish ‘thunbergiana’ / ‘Thunberg’ meaning ‘commemorating a botanist of this name’
thunbergii|From the Swedish ‘thunbergii’ / ‘Thunberg’ meaning ‘commemorating a botanist of this name’
thymifolia|From the Latin ‘thymi’ / ‘thymum’ meaning ‘thyme’; and the Latin ‘folia’ / ‘folium’ meaning ‘leaf’.
thyrsifera|From the Latin ‘thyrsi’ / ‘thyrsus’ meaning ‘stalk or thorn’; and the Latin ‘fera’ / ‘ferus’ meaning ‘bearing’.
thyrsiflora|From the Latin ‘thyrsi’ / ‘thyrsus’ meaning ‘rod’; and the Latin ‘flora’ / ‘flos’ meaning ‘flower’.
thyrsoides|From the Latin ‘thyrs’ / ‘thyrsus’ meaning ‘rod’; and the Greek ‘oides’ / ‘olens’ meaning ‘in the form of’.
tinctum|From the Latin ‘tinctum’ / ‘tincta’ meaning ‘dyed’
tomentosa|From the Latin ‘tomentosa’ / ‘tomentosus’ meaning ‘downy’
tomentosum|From the Latin ‘tomentosum’ / ‘tomentosus’ meaning ‘downy’
tongo|
tortuosa|From the Latin ‘tortuosa’ / ‘tortuosus’ meaning ‘winding’
trachysperma|From the Greek ‘trachy’ / ‘trachys’ meaning ‘rough’; and the Greek ‘sperma’ / ‘sperma’ meaning ‘seed’.
transparens|From the Latin ‘transparens’ / ‘transparens’ meaning ‘transparent’
triandra|From the Greek ‘tri’ / ‘tri’ meaning ‘three’; and the Greek ‘andra’ / ‘andros’ meaning ‘anther’.
triangularis|From the Latin ‘triangularis’ / ‘triangularis’ meaning ‘triangular’
trichodes|From the Greek ‘tricho’ / ‘thrix’ meaning ‘hair’; and the Greek ‘odes’ / ‘oides’ meaning ‘in the form of’.
trichophyllus|From the Greek ‘tricho’ / ‘thrix’ meaning ‘hair’; and the Greek ‘phyllus’ / ‘phyllon’ meaning ‘leaf’.
trichotomus|From the Greek ‘trichotomus’ / ‘trichotomos’ meaning ‘divided into three’
tricolor|From the Latin ‘tricolor’ / ‘tricolor’ meaning ‘three-coloured’
tricuspidata|From the Latin ‘tri’ / ‘tri’ meaning ‘three’; and the Latin ‘cuspidata’ / ‘cuspidatus’ meaning ‘pointed’.
tricuspidatus|From the Latin ‘tri’ / ‘tri’ meaning ‘three’; and the Latin ‘cuspidatus’ / ‘cuspidatus’ meaning ‘pointed’.
tridentata|From the Latin ‘tridentata’ / ‘tridentatus’ meaning ‘three-toothed’
triflora|From the Latin ‘triflora’ / ‘triflorus’ meaning ‘bearing three flowers’
triflorum|From the Latin ‘triflorum’ / ‘triflorus’ meaning ‘bearing three flowers’
triflorus|From the Latin ‘triflorus’ / ‘triflorus’ meaning ‘bearing three flowers’
trifurcata|From the Latin ‘trifurcata’ / ‘trifurcatus’ meaning ‘shaped like a trident’
triloba|From the Latin ‘triloba’ / ‘trilobus’ meaning ‘having three lobes’
trilopha|From the Greek ‘tri’ / ‘tri’ meaning ‘three’; and the Greek ‘lopha’ / ‘lophos’ meaning ‘crest’.
trinervia|From the Latin ‘trinervis’ / ‘trinervis’ meaning ‘having three nerves (or veins?)’
trionum|From the Latin ‘trionum’ / ‘trionus’ meaning ‘resembling the reptiles of the genus Trionyx’
tripetala|From the Greek ‘tripetala’ / ‘tripetalos’ meaning ‘three-petalled’
tripolium|From the Latin ‘tripolium’ / ‘tripolius’ meaning ‘having three divisions of pollen’
triqueter|From the Latin ‘triqueter’ / ‘triquetrus’ meaning ‘triangular’
triquetra|From the Latin ‘triquetra’ / ‘triquetrus’ meaning ‘triangular’
tristachya|From the Greek ‘tri’ / ‘tri’ meaning ‘three’; and the Greek ‘stachya’ / ‘stachys’ meaning ‘spike’.
triste|From the Latin ‘triste’ / ‘tristis’ meaning ‘sad’
tristis|From the Latin ‘tristis’ / ‘tristis’ meaning ‘sad’
triticea|From the Latin ‘triticea’ / ‘triticeus’ meaning ‘wheaten’
triticeus|From the Latin ‘triticeus’ / ‘triticeus’ meaning ‘wheaten’
tuberosa|From the Latin ‘tuberosa’ / ‘tuberosus’ meaning ‘lumpy’
tuberosum|From the Latin ‘tuberosum’ / ‘tuberosus’ meaning ‘lumpy’
tubulosa|From the Latin ‘tubulosa’ / ‘tubulosus’ meaning ‘equipped with small pipes’
tubulosus|From the Latin ‘tubulosus’ / ‘tubulosus’ meaning ‘equipped with small pipes’
tunbridgense|From the English ‘tunbridgense’ / ‘Tunbridge’ meaning ‘????commemorating a botanist of this name; deriving from Tunbridge Wells?’
turbinata|From the Latin ‘turbinata’ / ‘turbinatus’ meaning ‘conical’
turgida|From the Latin ‘turgida’ / ‘turgidus’ meaning ‘swollen’
umbellata|From the Latin ‘umbellata’ / ‘umbellatus’ meaning ‘equipped with parasols’
umbellatum|From the Latin ‘umbellatum’ / ‘umbellatus’ meaning ‘equipped with parasols’
umbellatus|From the Latin ‘umbellatus’ / ‘umbellatus’ meaning ‘equipped with parasols’
umbrosa|From the Latin ‘umbrosa’ / ‘umbrosus’ meaning ‘shady’
uncinata|From the Latin ‘uncinata’ / ‘uncinatus’ meaning ‘furnished with hooks’
undulata|From the Latin ‘undulata’ / ‘undulatus’ meaning ‘undulating’
undulatum|From the Latin ‘undulatum’ / ‘undulatus’ meaning ‘undulating’
undulatus|From the Latin ‘undulatus’ / ‘undulatus’ meaning ‘undulating’
unguicularis|From the Latin ‘unguicularis’ / ‘unguicularis’ meaning ‘claw-like’
unifolia|From the Latin ‘unifolia’ / ‘unifolius’ meaning ‘having one leaf’
uniolae|From the Latin ‘uniolae’ / ‘uniola’ meaning ‘unknown plant’
urceolata|From the Latin ‘urceolata’ / ‘urceolatus’ meaning ‘equipped with little pitchers’
urna-viridis|From the Latin ‘urna’ / ‘urna’ meaning ‘urn’; and the Latin ‘viridis’ / ‘viridis’ meaning ‘green’.
urvellei|From the German ‘urvelli’ / ‘Urvell?’ meaning ‘commemorating a botanist of this name’
ustulata|From the Latin ‘ustulata’ / ‘ustulatus’ meaning ‘slightly scorched’
utriculosa|From the Latin ‘utricolosa’ / ‘utricolosus’ meaning ‘equipped with tiny bottles’
uvaria|From the Latin ‘uvaria’ / ‘uvarius’ meaning ‘grape-like’
vaginata|From the Latin ‘vaginata’ / ‘vaginatus’ meaning ‘sheathed’
vaginatum|From the Latin ‘vaginatum’ / ‘vaginatus’ meaning ‘sheathed’
vaginatus|From the Latin ‘vaginatus’ / ‘vaginatus’ meaning ‘sheathed’
vaginellata|From the Latin ‘vaginellata’ / ‘vaginellatus’ meaning ‘equipped with tiny sheathes’
vaginulata|From the Latin ‘vaginulata’ / ‘vaginulatus’ meaning ‘somewhat sheathed’
valliantii|From the French ‘valliantii’ / ‘Valliant’ meaning ‘commemorating a botanist by this name’
variabilis|From the Latin ‘variabilis’ / ‘variabilis’ meaning ‘variable’
variegata|From the Latin ‘variegata’ / ‘variegatus’ meaning ‘variegated’
vegeta|From the Latin ‘vegeta’ / ‘vegetus’ meaning ‘vigorous’
venosa|From the Latin ‘venosa’ / ‘venosus’ meaning ‘veined’
ventosa|From the Latin ‘ventosa’ / ‘ventosus’ meaning ‘windy’
ventricosus|From the Latin ‘ventricosus’ / ‘ventricosus’ meaning ‘relating to the belly’
venusta|From the Latin ‘venusta’ / ‘venustus’ meaning ‘charming’
venustula|From the Latin ‘venustula’ / ‘venustulus’ meaning ‘somewhat charming’
verbascifolius|From the Latin ‘verbasci’ / ‘verbascum’ meaning ‘the plant of that name’; and the Latin ‘folius’ / ‘folium’ meaning ‘leaf’.
verreauxii|From the French ‘verreauxii’ / ‘Verraux’ meaning ‘commemorating the botanist of this name’
verrucosula|From the Latin ‘verrucosula’ / ‘verrucosulus’ meaning ‘somewhat warty’
versicolor|From the Latin ‘versicolor’ / ‘versicolor’ meaning ‘changing colour’
verticillata|From the Latin ‘verticillata’ / ‘verticillatus’ meaning ‘whirling’
veruculata|From the Latin ‘veruculata’ / ‘veruculatus’ meaning ‘furnished with small pikes’
vesicaria|From the Latin ‘vesicaria’ / ‘vesicarius’ meaning ‘bladder-like’
vesicatoria|From the Latin ‘vesicatoria’ / ‘vesicatorius’ meaning ‘relating to the bladder’
vestita|From the Latin ‘vestita’ / ‘vestitus’ meaning ‘clad’
vigilans|From the Latin ‘vigilans’ / ‘vigilans’ meaning ‘keeping watch’
villosa|From the Latin ‘villosa’ / ‘villosus’ meaning ‘shaggy’
villosula|From the Latin ‘villosula’ / ‘villosulus’ meaning ‘somewhat shaggy’
villosus|From the Latin ‘villosus’ / ‘villosus’ meaning ‘shaggy’
viminea|From the Latin ‘viminea’ / ‘vimineus’ meaning ‘willow-like’
violacea|From the Latin ‘violacea’ / ‘violaceus’ meaning ‘purple’
violifolia|From the Latin ‘violi’ / ‘viola’ meaning ‘violet’; and the Latin ‘folia’ / ‘folium’ meaning ‘leaf’.
virgata|From the Latin ‘virgata’ / ‘virgatus’ meaning ‘made of twigs’
virgatum|From the Latin ‘virgatum’ / ‘virgatus’ meaning ‘made of twigs’
virginicus|From the English ‘virginicus’ / ‘Virginia’ meaning ‘deriving from this state in the USA’
viride|From the Latin ‘viride’ / ‘viridis’ meaning ‘green’
viridifolium|From the Latin ‘viridi’ / ‘viridis’ meaning ‘green’; and the Latin ‘folium’ / ‘folium’ meaning ‘leaf’.
viridis|From the Latin ‘viridis’ / ‘viridis’ meaning ‘green’
viscaria|From the Latin ‘viscaria’ / ‘viscarius’ meaning ‘resembling mistletoe?????’
viscosa|From the Latin ‘viscosa’ / ‘viscosus’ meaning ‘sticky’
vitifolium|From the Latin ‘viti’ / ‘vitis’ meaning ‘vine’; and the Latin ‘folium’ / ‘folium’ meaning ‘leaf’.
volubilis|From the Latin ‘volubilis’ / ‘volubilis’ meaning ‘prone to turn around’
volucris|From the Latin ‘volucris’ / ‘volucris’ meaning ‘winged’
vulgare |From the Latin ‘vulgare’ / ‘vulgaris’ meaning ‘common’
vulgaris|From the Latin ‘vulgaris’ / ‘vulgaris’ meaning ‘common’
watsonius|From the English ‘watsonius’ / ‘Watson’ meaning ‘commemorating a botanist of that name’
whyteana|From the English ‘whyteana’ / ‘Whyte’ meaning ‘commemorating a biblical scholar of that name’
willdenowia|From the German ‘wildenowia’ / ‘Wildenow’ meaning ‘commemorating a botanist of that name’
wrightii|From the English ‘wrightii’ / ‘Wright’ meaning ‘commemorating a botanist of that name’
xanthoconus|From the Greek ‘xantho’ / ‘xanthos’ meaning ‘yellow’; and the Latin ‘conus’ / ‘conus’ meaning ‘cone’.
zeyheri|From the German ‘zeyheri’ / ‘Zeyher’ meaning ‘commemorating a botanist of that name’